Symbol	Description	Issuer
IVV	iShares Core S&P 500 ETF	iShares
IEFA	iShares Core MSCI EAFE ETF	iShares
AGG	iShares Core U.S. Aggregate Bond ETF	iShares
IWF	iShares Russell 1000 Growth ETF	iShares
IJH	iShares Core S&P Mid-Cap ETF	iShares
IEMG	iShares Core MSCI Emerging Markets ETF	iShares
IJR	iShares Core S&P Small-Cap ETF	iShares
IWM	iShares Russell 2000 ETF	iShares
ITOT	iShares Core S&P Total U.S. Stock Market ETF	iShares
IWD	iShares Russell 1000 Value ETF	iShares
EFA	iShares MSCI EAFE ETF	iShares
IVW	iShares S&P 500 Growth ETF	iShares
TLT	iShares 20+ Year Treasury Bond ETF	iShares
IBIT	iShares Bitcoin Trust ETF	iShares
QUAL	iShares MSCI USA Quality Factor ETF	iShares
IAU	iShares Gold Trust	iShares
IXUS	iShares Core MSCI Total International Stock ETF	iShares
MUB	iShares National Muni Bond ETF	iShares
SGOV	iShares 0-3 Month Treasury Bond ETF	iShares
IWR	iShares Russell Mid-Cap ETF	iShares
IWB	iShares Russell 1000 ETF	iShares
IVE	iShares S&P 500 Value ETF	iShares
MBB	iShares MBS ETF	iShares
IEF	iShares 7-10 Year Treasury Bond ETF	iShares
IUSB	iShares Core Total USD Bond Market ETF	iShares
DGRO	iShares Core Dividend Growth ETF	iShares
LQD	iShares iBoxx $ Investment Grade Corporate Bond ETF	iShares
GOVT	iShares U.S. Treasury Bond ETF	iShares
USMV	iShares MSCI USA Min Vol Factor ETF	iShares
SHY	iShares 1-3 Year Treasury Bond ETF	iShares
IGSB	iShares 1-5 Year Investment Grade Corporate Bond ETF	iShares
EFV	iShares MSCI EAFE Value ETF	iShares
IUSV	iShares Core S&P U.S. Value ETF	iShares
USHY	iShares Broad USD High Yield Corporate Bond ETF	iShares
SHV	iShares Short Treasury Bond ETF	iShares
IUSG	iShares Core S&P U.S. Growth ETF	iShares
DVY	iShares Select Dividend ETF	iShares
ACWI	iShares MSCI ACWI ETF	iShares
IDEV	iShares Core MSCI International Developed Markets ETF	iShares
IYW	iShares U.S. Technology ETF	iShares
IWP	iShares Russell Mid-Cap Growth ETF	iShares
EEM	iShares MSCI Emerging Markets ETF	iShares
OEF	iShares S&P 100 ETF	iShares
HYG	iShares iBoxx $ High Yield Corporate Bond ETF	iShares
DYNF	iShares U.S. Equity Factor Rotation Active ETF	iShares
IEI	iShares 3-7 Year Treasury Bond ETF	iShares
IGIB	iShares 5-10 Year Investment Grade Corporate Bond ETF	iShares
SLV	iShares Silver Trust	iShares
EMXC	iShares MSCI Emerging Markets ex China ETF	iShares
IWV	iShares Russell 3000 ETF	iShares
TIP	iShares TIPS Bond ETF	iShares
PFF	iShares Preferred and Income Securities ETF	iShares
MTUM	iShares MSCI USA Momentum Factor ETF	iShares
EMB	iShares J.P. Morgan USD Emerging Markets Bond ETF	iShares
EWJ	iShares MSCI Japan ETF	iShares
IWS	iShares Russell Mid-Cap Value ETF	iShares
ESGU	iShares ESG Aware MSCI USA ETF	iShares
USIG	iShares Broad USD Investment Grade Corporate Bond ETF	iShares
EFG	iShares MSCI EAFE Growth ETF	iShares
IWY	iShares Russell Top 200 Growth ETF	iShares
STIP	iShares 0-5 Year TIPS Bond ETF	iShares
SOXX	iShares Semiconductor ETF	iShares
HDV	iShares Core High Dividend ETF	iShares
IWN	iShares Russell 2000 Value ETF	iShares
IWO	iShares Russell 2000 Growth ETF	iShares
IGV	iShares Expanded Tech-Software Sector ETF	iShares
TLH	iShares 10-20 Year Treasury Bond ETF	iShares
SCZ	iShares MSCI EAFE Small-Cap ETF	iShares
ESGD	iShares ESG Aware MSCI EAFE ETF	iShares
FLOT	iShares Floating Rate Bond ETF	iShares
IQLT	iShares MSCI Intl Quality Factor ETF	iShares
EZU	iShares MSCI Eurozone ETF	iShares
SUB	iShares Short-Term National Muni Bond ETF	iShares
INDA	iShares MSCI India ETF	iShares
IJK	iShares S&P Mid-Cap 400 Growth ETF	iShares
BINC	iShares Flexible Income Active ETF	iShares
IJJ	iShares S&P Mid-Cap 400 Value ETF	iShares
HEFA	iShares Currency Hedged MSCI EAFE ETF	iShares
FXI	iShares China Large-Cap ETF	iShares
IAGG	iShares Core International Aggregate Bond ETF	iShares
VLUE	iShares MSCI USA Value Factor ETF	iShares
TFLO	iShares Treasury Floating Rate Bond ETF	iShares
IJS	iShares S&P Small-Cap 600 Value ETF	iShares
ITA	iShares U.S. Aerospace & Defense ETF	iShares
SHYG	iShares 0-5 Year High Yield Corporate Bond ETF	iShares
MCHI	iShares MSCI China ETF	iShares
IOO	iShares Global 100 ETF	iShares
IGF	iShares Global Infrastructure ETF	iShares
IBB	iShares Biotechnology ETF	iShares
IJT	iShares S&P Small-Cap 600 Growth ETF	iShares
ACWX	iShares MSCI ACWI ex U.S. ETF	iShares
ICSH	iShares Ultra Short-Term Bond Active ETF	iShares
IGM	iShares Expanded Tech Sector ETF	iShares
IEUR	iShares Core MSCI Europe ETF	iShares
EFAV	iShares MSCI EAFE Min Vol Factor ETF	iShares
IXN	iShares Global Tech ETF	iShares
IHI	iShares U.S. Medical Devices ETF	iShares
EWT	iShares MSCI Taiwan ETF	iShares
ESGE	iShares ESG Aware MSCI EM ETF	iShares
IDV	iShares International Select Dividend ETF	iShares
DSI	iShares ESG MSCI KLD 400 ETF	iShares
URTH	iShares MSCI World ETF	iShares
ISTB	iShares Core 1-5 Year USD Bond ETF	iShares
EEMV	iShares MSCI Emerging Markets Min Vol Factor ETF	iShares
IXJ	iShares Global Healthcare ETF	iShares
CMF	iShares California Muni Bond ETF	iShares
REET	iShares Global REIT ETF	iShares
EAGG	iShares ESG Aware U.S. Aggregate Bond ETF	iShares
IYF	iShares U.S. Financials ETF	iShares
IYR	iShares U.S. Real Estate ETF	iShares
SUSA	iShares MSCI USA ESG Select ETF	iShares
ACWV	iShares MSCI Global Min Vol Factor ETF	iShares
EWZ	iShares MSCI Brazil ETF	iShares
GVI	iShares Intermediate Government/Credit Bond ETF	iShares
IBDR	iShares® iBonds® Dec 2026 Term Corporate ETF	iShares
EWU	iShares MSCI United Kingdom ETF	iShares
NEAR	iShares Short Duration Bond Active ETF	iShares
IYH	iShares U.S. Healthcare ETF	iShares
IBDQ	iShares® iBonds® Dec 2025 Term Corporate ETF	iShares
IWX	iShares Russell Top 200 Value ETF	iShares
EWY	iShares MSCI South Korea ETF	iShares
XT	iShares Exponential Technologies ETF	iShares
EUFN	iShares MSCI Europe Financials ETF	iShares
IBDS	iShares® iBonds® Dec 2027 Term Corporate ETF	iShares
USRT	iShares Core U.S. REIT ETF	iShares
IBDT	iShares® iBonds® Dec 2028 Term Corporate ETF	iShares
IGLB	iShares 10+ Year Investment Grade Corporate Bond ETF	iShares
ICVT	iShares Convertible Bond ETF	iShares
EWC	iShares MSCI Canada ETF	iShares
IMCG	iShares Morningstar Mid-Cap Growth ETF	iShares
AAXJ	iShares MSCI All Country Asia ex Japan ETF	iShares
IBDU	iShares® iBonds® Dec 2029 Term Corporate ETF	iShares
IMTM	iShares MSCI Intl Momentum Factor ETF	iShares
ITB	iShares U.S. Home Construction ETF	iShares
ETHA	iShares Ethereum Trust ETF	iShares
LRGF	iShares U.S. Equity Factor ETF	iShares
ILCG	iShares Morningstar Growth ETF	iShares
AOR	iShares Core 60/40 Balanced Allocation ETF	iShares
SLQD	iShares 0-5 Year Investment Grade Corporate Bond ETF	iShares
IBTF	iShares® iBonds® Dec 2025 Term Treasury ETF	iShares
IYY	iShares Dow Jones U.S. ETF	iShares
IFRA	iShares U.S. Infrastructure ETF	iShares
USCL	iShares Climate Conscious & Transition MSCI USA ETF	iShares
AOA	iShares Core 80/20 Aggressive Allocation ETF	iShares
FALN	iShares Fallen Angels USD Bond ETF	iShares
IPAC	iShares Core MSCI Pacific ETF	iShares
EWG	iShares MSCI Germany ETF	iShares
PABU	iShares Paris-Aligned Climate MSCI USA ETF	iShares
IAUM	iShares Gold Trust Micro	iShares
IVLU	iShares MSCI Intl Value Factor ETF	iShares
ICF	iShares Cohen & Steers REIT ETF	iShares
IEV	iShares Europe ETF	iShares
EPP	iShares MSCI Pacific ex Japan ETF	iShares
HIMU	iShares High Yield Muni Active ETF	iShares
IXC	iShares Global Energy ETF	iShares
IBTG	iShares® iBonds® Dec 2026 Term Treasury ETF	iShares
ESML	iShares ESG Aware MSCI USA Small-Cap ETF	iShares
SMLF	iShares U.S. Small-Cap Equity Factor ETF	iShares
IBDV	iShares® iBonds® Dec 2030 Term Corporate ETF	iShares
IYG	iShares U.S. Financial Services ETF	iShares
HYDB	iShares High Yield Systematic Bond ETF	iShares
IYJ	iShares U.S. Industrials ETF	iShares
IWL	iShares Russell Top 200 ETF	iShares
QLTA	iShares Aaa - A Rated Corporate Bond ETF	iShares
IBTH	iShares® iBonds® Dec 2027 Term Treasury ETF	iShares
EWW	iShares MSCI Mexico ETF	iShares
IYK	iShares U.S. Consumer Staples ETF	iShares
AOM	iShares Core 40/60 Moderate Allocation ETF	iShares
IBDW	iShares® iBonds® Dec 2031 Term Corporate ETF	iShares
IAI	iShares U.S. Broker-Dealers & Securities Exchanges ETF	iShares
EWA	iShares MSCI Australia ETF	iShares
INTF	iShares International Equity Factor ETF	iShares
IYC	iShares U.S. Consumer Discretionary ETF	iShares
IDU	iShares U.S. Utilities ETF	iShares
ILF	iShares Latin America 40 ETF	iShares
SMMD	iShares Russell 2500 ETF	iShares
IYE	iShares U.S. Energy ETF	iShares
ICLN	iShares Global Clean Energy ETF	iShares
USXF	iShares ESG Advanced MSCI USA ETF	iShares
RING	iShares MSCI Global Gold Miners ETF	iShares
EUSA	iShares MSCI USA Equal Weighted ETF	iShares
LCTU	BlackRock U.S. Carbon Transition Readiness ETF	iShares
EWL	iShares MSCI Switzerland ETF	iShares
TLTW	iShares 20+ Year Treasury Bond BuyWrite Strategy ETF	iShares
SUSC	iShares ESG Aware USD Corporate Bond ETF	iShares
IGEB	iShares Investment Grade Systematic Bond ETF	iShares
GSG	iShares S&P GSCI Commodity-Indexed Trust	iShares
IBDX	iShares® iBonds® Dec 2032 Term Corporate ETF	iShares
IGRO	iShares International Dividend Growth ETF	iShares
IMCB	iShares Morningstar Mid-Cap ETF	iShares
ILCV	iShares Morningstar Value ETF	iShares
IBTI	iShares® iBonds® Dec 2028 Term Treasury ETF	iShares
SUSB	iShares ESG Aware 1-5 Year USD Corporate Bond ETF	iShares
ILCB	iShares Morningstar U.S. Equity ETF	iShares
CRBN	iShares MSCI ACWI Low Carbon Target ETF	iShares
EXI	iShares Global Industrials ETF	iShares
IHAK	iShares Cybersecurity and Tech ETF	iShares
SUSL	iShares ESG MSCI USA Leaders ETF	iShares
EWP	iShares MSCI Spain ETF	iShares
NYF	iShares New York Muni Bond ETF	iShares
REZ	iShares Residential and Multisector Real Estate ETF	iShares
IWC	iShares Micro-Cap ETF	iShares
MEAR	iShares Short Maturity Municipal Bond Active ETF	iShares
ARTY	iShares Future AI & Tech ETF	iShares
IBHF	iShares® iBonds® 2026 Term High Yield and Income ETF	iShares
EWS	iShares MSCI Singapore ETF	iShares
IAK	iShares U.S. Insurance ETF	iShares
EMGF	iShares Emerging Markets Equity Factor ETF	iShares
CLOA	iShares AAA CLO Active ETF	iShares
SMIN	iShares MSCI India Small-Cap ETF	iShares
PICK	iShares MSCI Global Metals & Mining Producers ETF	iShares
DMXF	iShares ESG Advanced MSCI EAFE ETF	iShares
AIA	iShares Asia 50 ETF	iShares
DVYE	iShares Emerging Markets Dividend ETF	iShares
IAT	iShares U.S. Regional Banks ETF	iShares
HEZU	iShares Currency Hedged MSCI Eurozone ETF	iShares
BIDD	iShares International Dividend Active ETF	iShares
IBDY	iShares® iBonds® Dec 2033 Term Corporate ETF	iShares
IHF	iShares U.S. Healthcare Providers ETF	iShares
KXI	iShares Global Consumer Staples ETF	iShares
DIVB	iShares Core Dividend ETF	iShares
EUSB	iShares ESG Advanced Total USD Bond Market ETF	iShares
KSA	iShares MSCI Saudi Arabia ETF	iShares
COMT	iShares GSCI Commodity Dynamic Roll Strategy ETF	iShares
ISCG	iShares Morningstar Small-Cap Growth ETF	iShares
REM	iShares Mortgage Real Estate ETF	iShares
IGE	iShares North American Natural Resources ETF	iShares
INDY	iShares India 50 ETF	iShares
AGZ	iShares Agency Bond ETF	iShares
EWH	iShares MSCI Hong Kong ETF	iShares
IMCV	iShares Morningstar Mid-Cap Value ETF	iShares
IBTJ	iShares® iBonds® Dec 2029 Term Treasury ETF	iShares
AOK	iShares Core 30/70 Conservative Allocation ETF	iShares
ILTB	iShares Core 10+ Year USD Bond ETF	iShares
IBHE	iShares® iBonds® 2025 Term High Yield and Income ETF	iShares
IHE	iShares U.S. Pharmaceuticals ETF	iShares
IYT	iShares U.S. Transportation ETF	iShares
ECH	iShares MSCI Chile ETF	iShares
IEO	iShares U.S. Oil & Gas Exploration & Production ETF	iShares
LQDH	iShares Interest Rate Hedged Corporate Bond ETF	iShares
THRO	iShares U.S. Thematic Rotation Active ETF	iShares
IBMP	iShares® iBonds® Dec 2027 Term Muni Bond ETF	iShares
IYM	iShares U.S. Basic Materials ETF	iShares
IBMO	iShares® iBonds® Dec 2026 Term Muni Bond ETF	iShares
EWQ	iShares MSCI France ETF	iShares
IXG	iShares Global Financials ETF	iShares
IBMN	iShares® iBonds® Dec 2025 Term Muni Bond ETF	iShares
EMHY	iShares J.P. Morgan EM High Yield Bond ETF	iShares
HYGH	iShares Interest Rate Hedged High Yield Bond ETF	iShares
IETC	iShares U.S. Tech Independence Focused ETF	iShares
CMBS	iShares CMBS ETF	iShares
IGOV	iShares International Treasury Bond ETF	iShares
ISCV	iShares Morningstar Small-Cap Value ETF	iShares
IBMQ	iShares® iBonds® Dec 2028 Term Muni Bond ETF	iShares
IYZ	iShares U.S. Telecommunications ETF	iShares
EWI	iShares MSCI Italy ETF	iShares
BGRN	iShares USD Green Bond ETF	iShares
TECB	iShares U.S. Tech Breakthrough Multisector ETF	iShares
EEMA	iShares MSCI Emerging Markets Asia ETF	iShares
HYBB	iShares BB Rated Corporate Bond ETF	iShares
CEMB	iShares J.P. Morgan EM Corporate Bond ETF	iShares
IBTK	iShares® iBonds® Dec 2030 Term Treasury ETF	iShares
EWD	iShares MSCI Sweden ETF	iShares
HEWJ	iShares Currency Hedged MSCI Japan ETF	iShares
EZA	iShares MSCI South Africa ETF	iShares
GNMA	iShares GNMA Bond ETF	iShares
IXP	iShares Global Comm Services ETF	iShares
IBTL	iShares® iBonds® Dec 2031 Term Treasury ETF	iShares
IBTO	iShares® iBonds® Dec 2033 Term Treasury ETF	iShares
EPOL	iShares MSCI Poland ETF	iShares
GARP	iShares MSCI USA Quality GARP ETF	iShares
ISCF	iShares International Small-Cap Equity Factor ETF	iShares
EWJV	iShares MSCI Japan Value ETF	iShares
SHYM	iShares High Yield Muni Income Active ETF	iShares
EEMS	iShares MSCI Emerging Markets Small-Cap ETF	iShares
IBTM	iShares® iBonds® Dec 2032 Term Treasury ETF	iShares
SIZE	iShares MSCI USA Size Factor ETF	iShares
LEMB	iShares J.P. Morgan EM Local Currency Bond ETF	iShares
XVV	iShares ESG Select Screened S&P 500 ETF	iShares
CMDY	iShares Bloomberg Roll Select Commodity Strategy ETF	iShares
IBDZ	iShares® iBonds® Dec 2034 Term Corporate ETF	iShares
SMMV	iShares MSCI USA Small-Cap Min Vol Factor ETF	iShares
GOVZ	iShares 25+ Year Treasury STRIPS Bond ETF	iShares
EIDO	iShares MSCI Indonesia ETF	iShares
IBHG	iShares® iBonds® 2027 Term High Yield and Income ETF	iShares
EWM	iShares MSCI Malaysia ETF	iShares
RXI	iShares Global Consumer Discretionary ETF	iShares
XJH	iShares ESG Select Screened S&P Mid-Cap ETF	iShares
SLVP	iShares MSCI Global Silver and Metals Miners ETF	iShares
HAWX	iShares Currency Hedged MSCI ACWI ex U.S. ETF	iShares
BALI	iShares Advantage Large Cap Income ETF	iShares
EWN	iShares MSCI Netherlands ETF	iShares
BYLD	iShares Yield Optimized Bond ETF	iShares
EIS	iShares MSCI Israel ETF	iShares
IVVB	iShares Large Cap Deep Buffer ETF	iShares
WOOD	iShares Global Timber & Forestry ETF	iShares
MXI	iShares Global Materials ETF	iShares
IMTB	iShares Core 5-10 Year USD Bond ETF	iShares
LQDW	iShares Investment Grade Corporate Bond BuyWrite Strategy ETF	iShares
HYGW	iShares High Yield Corporate Bond BuyWrite Strategy ETF	iShares
CNYA	iShares MSCI China A ETF	iShares
IBMR	iShares® iBonds® Dec 2029 Term Muni Bond ETF	iShares
LCTD	BlackRock World ex U.S. Carbon Transition Readiness ETF	iShares
ISCB	iShares Morningstar Small-Cap ETF	iShares
EDEN	iShares MSCI Denmark ETF	iShares
IBHH	iShares® iBonds® 2028 Term High Yield and Income ETF	iShares
TOK	iShares MSCI Kokusai ETF	iShares
BRTR	iShares Total Return Active ETF	iShares
TUR	iShares MSCI Turkey ETF	iShares
HYXF	iShares ESG Advanced High Yield Corporate Bond ETF	iShares
THD	iShares MSCI Thailand ETF	iShares
AQLT	iShares MSCI Global Quality Factor ETF	iShares
SDG	iShares MSCI Global Sustainable Development Goals ETF	iShares
TOPT	iShares Top 20 U.S. Stocks ETF	iShares
HEEM	iShares Currency Hedged MSCI Emerging Markets ETF	iShares
HSCZ	iShares Currency Hedged MSCI EAFE Small-Cap ETF	iShares
GHYG	iShares US & Intl High Yield Corp Bond ETF	iShares
JXI	iShares Global Utilities ETF	iShares
IDRV	iShares Self-Driving EV and Tech ETF	iShares
IEZ	iShares U.S. Oil Equipment & Services ETF	iShares
GBF	iShares Government/Credit Bond ETF	iShares
PMMF	iShares Prime Money Market ETF	iShares
IBHI	iShares® iBonds® 2029 Term High Yield and Income ETF	iShares
EPU	iShares MSCI Peru and Global Exposure ETF	iShares
SVAL	iShares US Small Cap Value Factor ETF	iShares
SMAX	iShares Large Cap Max Buffer Sep ETF	iShares
EWZS	iShares MSCI Brazil Small-Cap ETF	iShares
IDGT	iShares U.S. Digital Infrastructure and Real Estate ETF	iShares
MAXJ	iShares Large Cap Max Buffer Jun ETF	iShares
IYLD	iShares Morningstar Multi-Asset Income ETF	iShares
SCJ	iShares MSCI Japan Small-Cap ETF	iShares
IDNA	iShares Genomics Immunology and Healthcare ETF	iShares
UAE	iShares MSCI UAE ETF	iShares
IBTP	iShares® iBonds® Dec 2034 Term Treasury ETF	iShares
IGBH	iShares Interest Rate Hedged Long-Term Corporate Bond ETF	iShares
GLOF	iShares Global Equity Factor ETF	iShares
BAI	iShares A.I. Innovation and Tech Active ETF	iShares
IEUS	iShares MSCI Europe Small-Cap ETF	iShares
BRHY	iShares High Yield Active ETF	iShares
PABD	iShares Paris-Aligned Climate MSCI World ex USA ETF	iShares
VEGI	iShares MSCI Agriculture Producers ETF	iShares
QTOP	iShares Nasdaq Top 30 Stocks ETF	iShares
CSHP	iShares Enhanced Short-Term Bond Active ETF	iShares
XJR	iShares ESG Select Screened S&P Small-Cap ETF	iShares
EPHE	iShares MSCI Philippines ETF	iShares
LQDI	iShares Inflation Hedged Corporate Bond ETF	iShares
IFGL	iShares International Developed Real Estate ETF	iShares
JPXN	iShares JPX-Nikkei 400 ETF	iShares
FILL	iShares MSCI Global Energy Producers ETF	iShares
EMXF	iShares ESG Advanced MSCI EM ETF	iShares
ISHG	iShares 1-3 Year International Treasury Bond ETF	iShares
KWT	iShares MSCI Kuwait ETF	iShares
BKF	iShares MSCI BIC ETF	iShares
IVVM	iShares Large Cap Moderate Buffer ETF	iShares
EWO	iShares MSCI Austria ETF	iShares
DMAX	iShares Large Cap Max Buffer Dec ETF	iShares
QAT	iShares MSCI Qatar ETF	iShares
ENZL	iShares MSCI New Zealand ETF	iShares
FIBR	iShares U.S. Fixed Income Balanced Risk Systematic ETF	iShares
ECNS	iShares MSCI China Small-Cap ETF	iShares
BRLN	iShares Floating Rate Loan Active ETF	iShares
CALI	iShares Short-Term California Muni Active ETF	iShares
EIRL	iShares MSCI Ireland ETF	iShares
BCLO	iShares BBB-B CLO Active ETF	iShares
IBGA	iShares® iBonds® Dec 2044 Term Treasury ETF	iShares
IBHJ	iShares® iBonds® 2030 Term High Yield and Income ETF	iShares
INMU	iShares Intermediate Muni Income Active ETF	iShares
ICOP	iShares Copper and Metals Mining ETF	iShares
AGRH	iShares Interest Rate Hedged U.S. Aggregate Bond ETF	iShares
BEMB	iShares J.P. Morgan Broad USD Emerging Markets Bond ETF	iShares
IBMS	iShares® iBonds® Dec 2030 Term Muni Bond ETF	iShares
HYXU	iShares International High Yield Bond ETF	iShares
LQDB	iShares BBB Rated Corporate Bond ETF	iShares
CCRV	iShares Commodity Curve Carry Strategy ETF	iShares
IBIC	iShares® iBonds® Oct 2026 Term TIPS ETF	iShares
DVYA	iShares Asia/Pacific Dividend ETF	iShares
IVVW	iShares S&P 500 BuyWrite ETF	iShares
IBID	iShares® iBonds® Oct 2027 Term TIPS ETF	iShares
EWUS	iShares MSCI United Kingdom Small-Cap ETF	iShares
IBIK	iShares® iBonds® Oct 2034 Term TIPS ETF	iShares
IBIE	iShares® iBonds® Oct 2028 Term TIPS ETF	iShares
IBIF	iShares® iBonds® Oct 2029 Term TIPS ETF	iShares
GMMF	iShares Government Money Market ETF	iShares
ENOR	iShares MSCI Norway ETF	iShares
IBIB	iShares® iBonds® Oct 2025 Term TIPS ETF	iShares
IBLC	iShares Blockchain and Tech ETF	iShares
IEDI	iShares U.S. Consumer Focused ETF	iShares
EAOA	iShares ESG Aware 80/20 Aggressive Allocation ETF	iShares
ITDD	iShares® LifePath® Target Date 2040 ETF	iShares
IBIG	iShares® iBonds® Oct 2030 Term TIPS ETF	iShares
LDEM	iShares ESG MSCI EM Leaders ETF	iShares
ITDC	iShares® LifePath® Target Date 2035 ETF	iShares
ISVL	iShares International Developed Small Cap Value Factor ETF	iShares
IBIJ	iShares® iBonds® Oct 2033 Term TIPS ETF	iShares
BLCV	iShares Large Cap Value Active ETF	iShares
TCHI	iShares MSCI China Multisector Tech ETF	iShares
ITDE	iShares® LifePath® Target Date 2045 ETF	iShares
IBIH	iShares® iBonds® Oct 2031 Term TIPS ETF	iShares
ITDF	iShares® LifePath® Target Date 2050 ETF	iShares
IWMW	iShares Russell 2000 BuyWrite ETF	iShares
IBHK	iShares® iBonds® 2031 Term High Yield and Income ETF	iShares
INRO	iShares U.S. Industry Rotation Active ETF	iShares
EVUS	iShares ESG Aware MSCI USA Value ETF	iShares
EAOR	iShares ESG Aware 60/40 Balanced Allocation ETF	iShares
EGUS	iShares ESG Aware MSCI USA Growth ETF	iShares
LMUB	iShares Long-Term National Muni Bond ETF	iShares
FOVL	iShares Focused Value Factor ETF	iShares
ITDB	iShares® LifePath® Target Date 2030 ETF	iShares
EFNL	iShares MSCI Finland ETF	iShares
TEK	iShares Technology Opportunities Active ETF	iShares
IBII	iShares® iBonds® Oct 2032 Term TIPS ETF	iShares
LDRT	iShares® iBonds® 1-5 Year Treasury Ladder ETF	iShares
ISMF	iShares Managed Futures Active ETF	iShares
ITDG	iShares® LifePath® Target Date 2055 ETF	iShares
IRTR	iShares® LifePath® Retirement ETF	iShares
QNXT	iShares Nasdaq-100 ex Top 30 ETF	iShares
MADE	iShares U.S. Manufacturing ETF	iShares
TWOX	iShares Large Cap Accelerated ETF	iShares
ELQD	iShares ESG Advanced Investment Grade Corporate Bond ETF	iShares
EWK	iShares MSCI Belgium ETF	iShares
BELT	iShares Long-Term U.S. Equity Active ETF	iShares
IBHL	iShares® iBonds® 2032 Term High Yield and Income ETF	iShares
TMET	iShares Transition-Enabling Metals ETF	iShares
ITDH	iShares® LifePath® Target Date 2060 ETF	iShares
ERET	iShares Environmentally Aware Real Estate ETF	iShares
ITDI	iShares® LifePath® Target Date 2065 ETF	iShares
EMIF	iShares Emerging Markets Infrastructure ETF	iShares
ESMV	iShares ESG MSCI USA Min Vol Factor ETF	iShares
EAOK	iShares ESG Aware 30/70 Conservative Allocation ETF	iShares
EQLT	iShares MSCI Emerging Markets Quality Factor ETF	iShares
BLCR	iShares Large Cap Core Active ETF	iShares
EVLU	iShares MSCI Emerging Markets Value Factor ETF	iShares
IDAT	iShares Future Cloud 5G and Tech ETF	iShares
IBCA	iShares® iBonds® Dec 2035 Term Corporate ETF	iShares
IVRS	iShares Future Metaverse Tech and Communications ETF	iShares
LDRC	iShares® iBonds® 1-5 Year Corporate Ladder ETF	iShares
BGRO	iShares Large Cap Growth Active ETF	iShares
EAOM	iShares ESG Aware 40/60 Moderate Allocation ETF	iShares
CORO	iShares International Country Rotation Active ETF	iShares
IBAT	iShares Energy Storage & Materials ETF	iShares
BPAY	iShares FinTech Active ETF	iShares
IWTR	iShares MSCI Water Management Multisector ETF	iShares
HYGI	iShares Inflation Hedged High Yield Bond ETF	iShares
EFRA	iShares Environmental Infrastructure and Industrials ETF	iShares
LDRI	iShares® iBonds® 1-5 Year TIPS Ladder ETF	iShares
IVEG	iShares Emergent Food and AgTech Multisector ETF	iShares
LDRH	iShares® iBonds® 1-5 Year High Yield and Income Ladder ETF	iShares
ILIT	iShares Lithium Miners and Producers ETF	iShares
IBRN	iShares Neuroscience and Healthcare ETF	iShares
ETEC	iShares Breakthrough Environmental Solutions ETF	iShares
BMED	iShares Health Innovation Active ETF	iShares
IBTQ	iShares® iBonds® Dec 2035 Term Treasury ETF	iShares
IBMT	iShares® iBonds® Dec 2031 Term Muni Bond ETF	iShares
IBGB	iShares® iBonds® Dec 2045 Term Treasury ETF	iShares
IBGL	iShares® iBonds® Dec 2055 Term Treasury ETF	iShares
AGIH	iShares Inflation Hedged U.S. Aggregate Bond ETF	iShares
IBGK	iShares® iBonds® Dec 2054 Term Treasury ETF	iShares
ITDJ	iShares® LifePath® Target Date 2070 ETF	iShares
IBIL	iShares® iBonds® Oct 2035 Term TIPS ETF	iShares
HYBL	SPDR® Blackstone High Income ETF	SPDR
SRLN	SPDR® Blackstone Senior Loan ETF	SPDR
TIPX	SPDR® Bloomberg 1-10 Year TIPS ETF	SPDR
BIL	SPDR® Bloomberg 1-3 Month T-Bill ETF	SPDR
BILS	SPDR® Bloomberg 3-12 Month T-Bill ETF	SPDR
CWB	SPDR® Bloomberg Convertible Securities ETF	SPDR
EBND	SPDR® Bloomberg Emerging Markets Local Bond ETF	SPDR
EMHC	SPDR® Bloomberg Emerging Markets USD Bond ETF	SPDR
CERY	SPDR® Bloomberg Enhanced Roll Yield Commodity Strategy No K-1 ETF	SPDR
JNK	SPDR® Bloomberg High Yield Bond ETF	SPDR
IBND	SPDR® Bloomberg International Corporate Bond ETF	SPDR
BWX	SPDR® Bloomberg International Treasury Bond ETF	SPDR
FLRN	SPDR® Bloomberg Investment Grade Floating Rate ETF	SPDR
SJNK	SPDR® Bloomberg Short Term High Yield Bond ETF	SPDR
BWZ	SPDR® Bloomberg Short Term International Treasury Bond ETF	SPDR
ALLW	SPDR® Bridgewater® All Weather® ETF	SPDR
EMTL	SPDR® DoubleLine® Emerging Markets Fixed Income ETF	SPDR
STOT	SPDR® DoubleLine® Short Duration Total Return Tactical ETF	SPDR
TOTL	SPDR® DoubleLine® Total Return Tactical ETF	SPDR
RWO	SPDR® Dow Jones® Global Real Estate ETF	SPDR
DIA	SPDR® Dow Jones® Industrial Average℠ ETF Trust	SPDR
RWX	SPDR® Dow Jones® International Real Estate ETF	SPDR
RWR	SPDR® Dow Jones® REIT ETF	SPDR
FEZ	SPDR® EURO STOXX 50® ETF	SPDR
XITK	SPDR® FactSet Innovative Technology ETF	SPDR
WIP	SPDR® FTSE International Government Inflation-Protected Bond ETF	SPDR
DECO	SPDR® Galaxy Digital Asset Ecosystem ETF	SPDR
HECO	SPDR® Galaxy Hedged Digital Asset Ecosystem ETF	SPDR
TEKX	SPDR® Galaxy Transformative Tech Accelerators ETF	SPDR
DGT	SPDR® Global Dow ETF	SPDR
GLDM®	SPDR® Gold MiniShares® Trust	SPDR
GLD®	SPDR® Gold Shares	SPDR
PSK	SPDR® ICE Preferred Securities ETF	SPDR
OBND	SPDR® Loomis Sayles Opportunistic Bond ETF	SPDR
LQIG	SPDR® MarketAxess Investment Grade 400 Corporate Bond ETF	SPDR
NZAC	SPDR® MSCI ACWI Climate Paris Aligned ETF	SPDR
CWI	SPDR® MSCI ACWI ex-US ETF	SPDR
EFAX	SPDR® MSCI EAFE Fossil Fuel Reserves Free ETF	SPDR
QEFA	SPDR® MSCI EAFE StrategicFactors℠ ETF	SPDR
EEMX	SPDR® MSCI Emerging Markets Fossil Fuel Reserves Free ETF	SPDR
QEMM	SPDR® MSCI Emerging Markets StrategicFactors℠ ETF	SPDR
NZUS	SPDR® MSCI USA Climate Paris Aligned ETF	SPDR
SHE	SPDR® MSCI USA Gender Diversity ETF	SPDR
QUS	SPDR® MSCI USA StrategicFactors℠ ETF	SPDR
QWLD	SPDR® MSCI World StrategicFactors℠ ETF	SPDR
HYMB	SPDR® Nuveen Bloomberg High Yield Municipal Bond ETF	SPDR
TFI	SPDR® Nuveen Bloomberg Municipal Bond ETF	SPDR
SHM	SPDR® Nuveen Bloomberg Short Term Municipal Bond ETF	SPDR
MBNE	SPDR® Nuveen Municipal Bond ESG ETF	SPDR
MBND	SPDR® Nuveen Municipal Bond ETF	SPDR
XNTK	SPDR® NYSE Technology ETF	SPDR
SPAB	SPDR® Portfolio Aggregate Bond ETF	SPDR
SPBO	SPDR® Portfolio Corporate Bond ETF	SPDR
SPDW	SPDR® Portfolio Developed World ex-US ETF	SPDR
SPEM	SPDR® Portfolio Emerging Markets ETF	SPDR
SPEU	SPDR® Portfolio Europe ETF	SPDR
SPHY	SPDR® Portfolio High Yield Bond ETF	SPDR
SPIB	SPDR® Portfolio Intermediate Term Corporate Bond ETF	SPDR
SPTI	SPDR® Portfolio Intermediate Term Treasury ETF	SPDR
SPLB	SPDR® Portfolio Long Term Corporate Bond ETF	SPDR
SPTL	SPDR® Portfolio Long Term Treasury ETF	SPDR
SPMB	SPDR® Portfolio Mortgage Backed Bond ETF	SPDR
SPGM	SPDR® Portfolio MSCI Global Stock Market ETF	SPDR
SPTM	SPDR® Portfolio S&P 1500® Composite Stock Market ETF	SPDR
SPMD	SPDR® Portfolio S&P 400™ Mid Cap ETF	SPDR
SPLG	SPDR® Portfolio S&P 500® ETF	SPDR
SPYG	SPDR® Portfolio S&P 500® Growth ETF	SPDR
SPYD	SPDR® Portfolio S&P 500® High Dividend ETF	SPDR
SPYV	SPDR® Portfolio S&P 500® Value ETF	SPDR
SPSM	SPDR® Portfolio S&P 600™ Small Cap ETF	SPDR
SPDG	SPDR® Portfolio S&P Sector Neutral Dividend ETF	SPDR
SPSB	SPDR® Portfolio Short Term Corporate Bond ETF	SPDR
SPTS	SPDR® Portfolio Short Term Treasury ETF	SPDR
SPIP	SPDR® Portfolio TIPS ETF	SPDR
SPTB	SPDR® Portfolio Treasury ETF	SPDR
ONEV	SPDR® Russell 1000 Low Volatility Focus ETF	SPDR
ONEO	SPDR® Russell 1000 Momentum Focus ETF	SPDR
ONEY	SPDR® Russell 1000 Yield Focus ETF	SPDR
MDYG	SPDR® S&P 400™ Mid Cap Growth ETF	SPDR
MDYV	SPDR® S&P 400™ Mid Cap Value ETF	SPDR
EFIV	SPDR® S&P 500® ESG ETF	SPDR
SPY	SPDR® S&P 500® ETF Trust	SPDR
SLYG	SPDR® S&P 600™ Small Cap Growth ETF	SPDR
SLYV	SPDR® S&P 600™ Small Cap Value ETF	SPDR
EDIV	SPDR® S&P Emerging Markets Dividend ETF	SPDR
XCNY	SPDR® S&P Emerging Markets ex-China ETF	SPDR
CNRG	SPDR® S&P Kensho Clean Power ETF	SPDR
ROKT	SPDR® S&P Kensho Final Frontiers ETF	SPDR
FITE	SPDR® S&P Kensho Future Security ETF	SPDR
SIMS	SPDR® S&P Kensho Intelligent Structures ETF	SPDR
KOMP	SPDR® S&P Kensho New Economies Composite ETF	SPDR
HAIL	SPDR® S&P Kensho Smart Mobility ETF	SPDR
MDY	SPDR® S&P MIDCAP 400® ETF Trust	SPDR
ESIX	SPDR® S&P SmallCap 600 ESG ETF	SPDR
MMTM	SPDR® S&P® 1500 Momentum Tilt ETF	SPDR
VLU	SPDR® S&P® 1500 Value Tilt ETF	SPDR
SPYX	SPDR® S&P® 500 Fossil Fuel Reserves Free ETF	SPDR
XAR	SPDR® S&P® Aerospace & Defense ETF	SPDR
KBE	SPDR® S&P® Bank ETF	SPDR
XBI	SPDR® S&P® Biotech ETF	SPDR
KCE	SPDR® S&P® Capital Markets ETF	SPDR
GXC	SPDR® S&P® China ETF	SPDR
SDY	SPDR® S&P® Dividend ETF	SPDR
GMF	SPDR® S&P® Emerging Asia Pacific ETF	SPDR
EWX	SPDR® S&P® Emerging Markets Small Cap ETF	SPDR
WDIV	SPDR® S&P® Global Dividend ETF	SPDR
GII	SPDR® S&P® Global Infrastructure ETF	SPDR
GNR	SPDR® S&P® Global Natural Resources ETF	SPDR
XHE	SPDR® S&P® Health Care Equipment ETF	SPDR
XHS	SPDR® S&P® Health Care Services ETF	SPDR
XHB	SPDR® S&P® Homebuilders ETF	SPDR
KIE	SPDR® S&P® Insurance ETF	SPDR
DWX	SPDR® S&P® International Dividend ETF	SPDR
GWX	SPDR® S&P® International Small Cap ETF	SPDR
XME	SPDR® S&P® Metals & Mining ETF	SPDR
NANR	SPDR® S&P® North American Natural Resources ETF	SPDR
XES	SPDR® S&P® Oil & Gas Equipment & Services ETF	SPDR
XOP	SPDR® S&P® Oil & Gas Exploration & Production ETF	SPDR
XPH	SPDR® S&P® Pharmaceuticals ETF	SPDR
KRE	SPDR® S&P® Regional Banking ETF	SPDR
XRT	SPDR® S&P® Retail ETF	SPDR
XSD	SPDR® S&P® Semiconductor ETF	SPDR
XSW	SPDR® S&P® Software & Services ETF	SPDR
XTL	SPDR® S&P® Telecom ETF	SPDR
XTN	SPDR® S&P® Transportation ETF	SPDR
FISR	SPDR® SSGA Fixed Income Sector Rotation ETF	SPDR
GAL	SPDR® SSGA Global Allocation ETF	SPDR
PRIV	SPDR® SSGA IG Public & Private Credit ETF	SPDR
INKM	SPDR® SSGA Income Allocation ETF	SPDR
RLY	SPDR® SSGA Multi-Asset Real Return ETF	SPDR
MYCF	SPDR® SSGA My2026 Corporate Bond ETF	SPDR
MYMF	SPDR® SSGA My2026 Municipal Bond ETF	SPDR
MYCG	SPDR® SSGA My2027 Corporate Bond ETF	SPDR
MYMG	SPDR® SSGA My2027 Municipal Bond ETF	SPDR
MYCH	SPDR® SSGA My2028 Corporate Bond ETF	SPDR
MYMH	SPDR® SSGA My2028 Municipal Bond ETF	SPDR
MYCI	SPDR® SSGA My2029 Corporate Bond ETF	SPDR
MYMI	SPDR® SSGA My2029 Municipal Bond ETF	SPDR
MYCJ	SPDR® SSGA My2030 Corporate Bond ETF	SPDR
MYMJ	SPDR® SSGA My2030 Municipal Bond ETF	SPDR
MYCK	SPDR® SSGA My2031 Corporate Bond ETF	SPDR
MYCL	SPDR® SSGA My2032 Corporate Bond ETF	SPDR
MYCM	SPDR® SSGA My2033 Corporate Bond ETF	SPDR
MYCN	SPDR® SSGA My2034 Corporate Bond ETF	SPDR
ULST	SPDR® SSGA Ultra Short Term Bond ETF	SPDR
SPIN	SPDR® SSGA US Equity Premium Income ETF	SPDR
LGLV	SPDR® SSGA US Large Cap Low Volatility Index ETF	SPDR
XLSR	SPDR® SSGA US Sector Rotation ETF	SPDR
SMLV	SPDR® SSGA US Small Cap Low Volatility Index ETF	SPDR
XLC	The Communication Services Select Sector SPDR® Fund	SPDR
XLY	The Consumer Discretionary Select Sector SPDR® Fund	SPDR
XLP	The Consumer Staples Select Sector SPDR® Fund	SPDR
XLE	The Energy Select Sector SPDR® Fund	SPDR
XLF	The Financial Select Sector SPDR® Fund	SPDR
XLV	The Health Care Select Sector SPDR® Fund	SPDR
XLI	The Industrial Select Sector SPDR® Fund	SPDR
XLB	The Materials Select Sector SPDR® Fund	SPDR
XLRE	The Real Estate Select Sector SPDR® Fund	SPDR
XLK	The Technology Select Sector SPDR® Fund	SPDR
XLU	The Utilities Select Sector SPDR® Fund	SPDR
ICLO	AAA CLO Floating Rate Note ETF	Invesco
BKLN	Senior Loan ETF	Invesco
PDBA	Agriculture Commodity Strategy No K-1 ETF	Invesco
DBA	DB Agriculture Fund	Invesco
DBB	DB Base Metals Fund	Invesco
DBC	DB Commodity Index Tracking Fund	Invesco
DBE	DB Energy Fund	Invesco
DBO	DB Oil Fund	Invesco
DBP	DB Precious Metals Fund	Invesco
EVMT	Electric Vehicle Metals Commodity Strategy No K-1 ETF	Invesco
IMF	Managed Futures Strategy ETF	Invesco
PDBC	Invesco Optimum Yield Diversified Commodity Strategy No K-1 ETF	Invesco
FXA	CurrencyShares® Australian Dollar Trust	Invesco
FXB	CurrencyShares® British Pound Sterling Trust	Invesco
FXC	CurrencyShares® Canadian Dollar Trust	Invesco
FXE	CurrencyShares® Euro Trust	Invesco
FXY	CurrencyShares® Japanese Yen Trust	Invesco
FXF	CurrencyShares® Swiss Franc Trust	Invesco
UDN	DB US Dollar Index Bearish Fund	Invesco
UUP	DB US Dollar Index Bullish Fund	Invesco
BLKC	Alerian Galaxy Blockchain Users and Decentralized Commerce ETF	Invesco
SATO	Alerian Galaxy Crypto Economy ETF	Invesco
BTCO	Galaxy Bitcoin ETF	Invesco
QETH	Galaxy Ethereum ETF	Invesco
PBP	S&P 500 BuyWrite ETF	Invesco
PHDG	S&P 500® Downside Hedged ETF	Invesco
PSP	Global Listed Private Equity ETF	Invesco
PSR	Active U.S. Real Estate ETF	Invesco
KBWY	KBW Premium Yield Equity REIT ETF	Invesco
CVY	Zacks Multi-Asset Income ETF	Invesco
CQQQ	China Technology ETF	Invesco
PIZ	Dorsey Wright Developed Markets Momentum ETF	Invesco
PIE	Dorsey Wright Emerging Markets Momentum ETF	Invesco
PGJ	Golden Dragon China ETF	Invesco
PIN	India ETF	Invesco
IPKW	International BuyBack Achievers™ ETF	Invesco
IMFL	International Developed Dynamic Multifactor ETF	Invesco
PID	International Dividend Achievers™ ETF	Invesco
EFAA	MSCI EAFE Income Advantage ETF	Invesco
KLMT	MSCI Global Climate 500 ETF	Invesco
GBLD	MSCI Green Building ETF	Invesco
PXF	RAFI Developed Markets ex-U.S. ETF	Invesco
PDN	RAFI Developed Markets ex-U.S. Small-Mid ETF	Invesco
PXH	RAFI Emerging Markets ETF	Invesco
EELV	S&P Emerging Markets Low Volatility ETF	Invesco
EEMO	S&P Emerging Markets Momentum ETF	Invesco
IDLV	S&P International Developed Low Volatility ETF	Invesco
IDMO	S&P International Developed Momentum ETF	Invesco
IDHQ	S&P International Developed Quality ETF	Invesco
IGPT	AI and Next Gen Software ETF	Invesco
PPA	Aerospace & Defense ETF	Invesco
PBE	Biotechnology & Genome ETF	Invesco
PKB	Building & Construction ETF	Invesco
PYZ	Dorsey Wright Basic Materials Momentum ETF	Invesco
PEZ	Dorsey Wright Consumer Cyclicals Momentum ETF	Invesco
PSL	Dorsey Wright Consumer Staples Momentum ETF	Invesco
PXI	Dorsey Wright Energy Momentum ETF	Invesco
PFI	Dorsey Wright Financial Momentum ETF	Invesco
PTH	Dorsey Wright Healthcare Momentum ETF	Invesco
PRN	Dorsey Wright Industrials Momentum ETF	Invesco
PTF	Dorsey Wright Technology Momentum ETF	Invesco
PUI	Dorsey Wright Utilities Momentum ETF	Invesco
PXE	Energy Exploration & Production ETF	Invesco
PBJ	Food & Beverage ETF	Invesco
PBD	Global Clean Energy ETF	Invesco
PIO	Global Water ETF	Invesco
KBWB	KBW Bank ETF	Invesco
KBWP	KBW Property & Casualty Insurance ETF	Invesco
KBWR	KBW Regional Banking ETF	Invesco
PEJ	Leisure and Entertainment ETF	Invesco
CUT	MSCI Global Timber ETF	Invesco
KLMN	MSCI North America Climate ETF	Invesco
ERTH	MSCI Sustainable Future ETF	Invesco
PNQI	NASDAQ Internet ETF	Invesco
IBBQ	Nasdaq Biotechnology ETF	Invesco
KNCT	Next Gen Connectivity ETF	Invesco
GGME	Next Gen Media and Gaming ETF	Invesco
PXJ	Oil & Gas Services ETF	Invesco
SOXQ	PHLX Semiconductor ETF	Invesco
PJP	Pharmaceuticals ETF	Invesco
RSPC	S&P 500 Equal Weight Communication Services ETF	Invesco
RSPD	S&P 500® Equal Weight Consumer Discretionary ETF	Invesco
RSPS	S&P 500® Equal Weight Consumer Staples ETF	Invesco
RSPG	S&P 500® Equal Weight Energy ETF	Invesco
RSPF	S&P 500® Equal Weight Financials ETF	Invesco
RSPH	S&P 500® Equal Weight Health Care ETF	Invesco
RSPN	S&P 500® Equal Weight Industrials ETF	Invesco
RSPM	S&P 500® Equal Weight Materials ETF	Invesco
RSPR	S&P 500® Equal Weight Real Estate ETF	Invesco
RSPT	S&P 500® Equal Weight Technology ETF	Invesco
RSPU	S&P 500® Equal Weight Utilities ETF	Invesco
CGW	S&P Global Water Index ETF	Invesco
PSCD	S&P SmallCap Consumer Discretionary ETF	Invesco
PSCC	S&P SmallCap Consumer Staples ETF	Invesco
PSCE	S&P SmallCap Energy ETF	Invesco
PSCF	S&P SmallCap Financials ETF	Invesco
PSCH	S&P SmallCap Health Care ETF	Invesco
PSCI	S&P SmallCap Industrials ETF	Invesco
PSCT	S&P SmallCap Information Technology ETF	Invesco
PSCM	S&P SmallCap Materials ETF	Invesco
PSCU	S&P SmallCap Utilities & Communication Services ETF	Invesco
PSI	Semiconductors ETF	Invesco
TAN	Solar ETF	Invesco
PIPE	SteelPath MLP & Energy Infrastructure ETF	Invesco
PHO	Water Resources ETF	Invesco
PBW	WilderHill Clean Energy ETF	Invesco
UPGD	Bloomberg Analyst Rating Improvers ETF	Invesco
BMVP	Bloomberg MVP Multi-factor ETF	Invesco
POWA	Bloomberg Pricing Power ETF	Invesco
PKW	BuyBack Achievers™ ETF	Invesco
PCEF	CEF Income Composite ETF	Invesco
PFM	Dividend Achievers™ ETF	Invesco
PDP	Dorsey Wright Momentum ETF	Invesco
DWAS	Dorsey Wright SmallCap Momentum ETF	Invesco
DJD	Dow Jones Industrial Average Dividend ETF	Invesco
QQMG	ESG NASDAQ 100 ETF	Invesco
QQJG	ESG NASDAQ Next Gen 100 ETF	Invesco
RSPE	ESG S&P 500 Equal Weight ETF	Invesco
PGF	Financial Preferred ETF	Invesco
PEY	High Yield Equity Dividend Achievers™ ETF	Invesco
KBWD	KBW High Dividend Yield Financial ETF	Invesco
PWB	Large Cap Growth ETF	Invesco
PWV	Large Cap Value ETF	Invesco
PBUS	MSCI USA ETF	Invesco
QQQM	Invesco NASDAQ 100 ETF	Invesco
QQQS	NASDAQ Future Gen 200 ETF	Invesco
QQQJ	Invesco NASDAQ Next Gen 100 ETF	Invesco
QOWZ	Nasdaq Free Cash Flow Achievers ETF	Invesco
PGX	Preferred ETF	Invesco
QQQ	QQQ Trust	Invesco
QQA	QQQ Income Advantage ETF	Invesco
QQLV	QQQ Low Volatility ETF	Invesco
PRF	RAFI US 1000 ETF	Invesco
PRFZ	RAFI US 1500 Small-Mid ETF	Invesco
IUS	Strategic US ETF	Invesco
IVRA	Real Assets ESG ETF	Invesco
EQAL	Russell 1000 Equal Weight ETF	Invesco
OMFL	Russell 1000® Dynamic Multifactor ETF	Invesco
OMFS	Russell 2000® Dynamic Multifactor ETF	Invesco
EQWL	S&P 100 Equal Weight ETF	Invesco
RSPA	S&P 500 Equal Weight Income Advantage ETF	Invesco
SPGP	S&P 500 GARP ETF	Invesco
DIVG	S&P 500 High Dividend Growers ETF	Invesco
SPMV	S&P 500 Minimum Variance ETF	Invesco
QVML	S&P 500 QVM Multi-factor ETF	Invesco
RWL	S&P 500 Revenue ETF	Invesco
SPVM	S&P 500 Value with Momentum ETF	Invesco
SPVU	S&P 500® Enhanced Value ETF	Invesco
RSP	S&P 500® Equal Weight ETF	Invesco
SPHB	S&P 500® High Beta ETF	Invesco
SPHD	S&P 500® High Dividend Low Volatility ETF	Invesco
SPLV	S&P 500® Low Volatility ETF	Invesco
SPMO	S&P 500® Momentum ETF	Invesco
RPG	S&P 500® Pure Growth ETF	Invesco
RPV	S&P 500® Pure Value ETF	Invesco
SPHQ	S&P 500® Quality ETF	Invesco
XLG	S&P 500® Top 50 ETF	Invesco
XRLV	S&P 500® ex-Rate Sensitive Low Volatility ETF	Invesco
QVMM	S&P MidCap 400 QVM Multi-factor ETF	Invesco
RWK	S&P MidCap 400 Revenue ETF	Invesco
GRPM	S&P MidCap 400® GARP ETF	Invesco
RFG	S&P MidCap 400® Pure Growth ETF	Invesco
RFV	S&P MidCap 400® Pure Value ETF	Invesco
XMLV	S&P MidCap Low Volatility ETF	Invesco
XMMO	S&P MidCap Momentum ETF	Invesco
XMHQ	S&P MidCap Quality ETF	Invesco
XMVM	S&P MidCap Value with Momentum ETF	Invesco
GRPZ	S&P SmallCap 600 GARP ETF	Invesco
QVMS	S&P SmallCap 600 QVM Multi-factor ETF	Invesco
RWJ	S&P SmallCap 600 Revenue ETF	Invesco
RZG	S&P SmallCap 600® Pure Growth ETF	Invesco
RZV	S&P SmallCap 600® Pure Value ETF	Invesco
XSHD	S&P SmallCap High Dividend Low Volatility ETF	Invesco
XSLV	S&P SmallCap Low Volatility ETF	Invesco
XSMO	S&P SmallCap Momentum ETF	Invesco
XSHQ	S&P SmallCap Quality ETF	Invesco
XSVM	S&P SmallCap Value with Momentum ETF	Invesco
CSD	S&P Spin-Off ETF	Invesco
RDIV	S&P Ultra Dividend Revenue ETF	Invesco
QBIG	Top QQQ ETF	Invesco
VRP	Variable Rate Preferred ETF	Invesco
CZA	Zacks Mid-Cap ETF	Invesco
PCY	Emerging Markets Sovereign Debt ETF	Invesco
PGHY	Global ex-US High Yield Corporate Bond ETF	Invesco
PICB	International Corporate Bond ETF	Invesco
PBTP	0-5 Yr US TIPS ETF	Invesco
BSCP	BulletShares 2025 Corporate Bond ETF	Invesco
BSJP	BulletShares 2025 High Yield Corporate Bond ETF	Invesco
BSMP	BulletShares 2025 Municipal Bond ETF	Invesco
BSCQ	BulletShares 2026 Corporate Bond ETF	Invesco
BSJQ	BulletShares 2026 High Yield Corporate Bond ETF	Invesco
BSMQ	BulletShares 2026 Municpal Bond ETF	Invesco
BSCR	BulletShares 2027 Corporate Bond ETF	Invesco
BSJR	BulletShares 2027 High Yield Corporate Bond ETF	Invesco
BSMR	BulletShares 2027 Municipal Bond ETF	Invesco
BSCS	BulletShares 2028 Corporate Bond ETF	Invesco
BSJS	BulletShares 2028 High Yield Corporate Bond ETF	Invesco
BSMS	BulletShares 2028 Municipal Bond ETF	Invesco
BSCT	BulletShares 2029 Corporate Bond ETF	Invesco
BSJT	BulletShares 2029 High Yield Corporate Bond ETF	Invesco
BSMT	BulletShares 2029 Municipal Bond ETF	Invesco
BSCU	BulletShares 2030 Corporate Bond ETF	Invesco
BSJU	BulletShares 2030 High Yield Corporate Bond ETF	Invesco
BSMU	BulletShares 2030 Municipal Bond ETF	Invesco
BSCV	BulletShares 2031 Corporate Bond ETF	Invesco
BSJV	BulletShares 2031 High Yield Corporate Bond ETF	Invesco
BSMV	BulletShares 2031 Municipal Bond ETF	Invesco
BSCW	BulletShares 2032 Corporate Bond ETF	Invesco
BSJW	BulletShares 2032 High Yield Corporate Bond ETF	Invesco
BSMW	BulletShares 2032 Municipal Bond ETF	Invesco
BSCX	BulletShares 2033 Corporate Bond ETF	Invesco
BSSX	BulletShares 2033 Municipal Bond ETF	Invesco
BSCY	BulletShares 2034 Corporate Bond ETF	Invesco
BSMY	BulletShares 2034 Municipal Bond ETF	Invesco
PWZ	California AMT-Free Municipal Bond ETF	Invesco
GOVI	Equal Weight 0-30 Year Treasury ETF	Invesco
PVI	Floating Rate Municipal Income ETF	Invesco
PHB	Fundamental High Yield® Corporate Bond ETF	Invesco
PFIG	Fundamental Investment Grade Corporate Bond ETF	Invesco
IHYF	High Yield Bond Factor ETF	Invesco
HIYS	High Yield Select ETF	Invesco
IIGD	Investment Grade Defensive ETF	Invesco
PZA	National AMT-Free Municipal Bond ETF	Invesco
PZT	New York AMT-Free Municipal Bond ETF	Invesco
IROC	Rochester High Yield Municipal ETF	Invesco
GTOS	Short Duration Total Return Bond ETF	Invesco
TBLL	Short Term Treasury ETF	Invesco
BAB	Taxable Municipal Bond ETF	Invesco
GTO	Total Return Bond ETF	Invesco
GSY	Ultra Short Duration ETF	Invesco
VRIG	Variable Rate Investment Grade ETF	Invesco
GLL	UltraShort Gold	Proshares
MYY	Short MidCap400	Proshares
DOG	Short Dow30	Proshares
PSQ	Short QQQ	Proshares
SH	Short S&P500	Proshares
MVV	Ultra MidCap400	Proshares
DDM	Ultra Dow30	Proshares
QLD	Ultra QQQ	Proshares
SSO	Ultra S&P500	Proshares
DXD	UltraShort Dow30	Proshares
QID	UltraShort QQQ	Proshares
MZZ	UltraShort MidCap400	Proshares
SDS	UltraShort S&P500	Proshares
CMD	UltraShort Bloomberg Commodity	Proshares
SCO	UltraShort Bloomberg Crude Oil	Proshares
ZSL	UltraShort Silver	Proshares
EUO	UltraShort Euro	Proshares
YCS	UltraShort Yen	Proshares
SDD	UltraShort SmallCap600	Proshares
TWM	UltraShort Russell2000	Proshares
UWM	Ultra Russell2000	Proshares
RWM	Short Russell2000	Proshares
SAA	Ultra SmallCap600	Proshares
SBB	Short SmallCap600	Proshares
SRS	UltraShort Real Estate	Proshares
SDP	UltraShort Utilities	Proshares
SCC	UltraShort Consumer Discretionary	Proshares
SIJ	UltraShort Industrials	Proshares
UYG	Ultra Financials	Proshares
URE	Ultra Real Estate	Proshares
DUG	UltraShort Energy	Proshares
SSG	UltraShort Semiconductors	Proshares
REW	UltraShort Technology	Proshares
SKF	UltraShort Financials	Proshares
SMN	UltraShort Materials	Proshares
UYM	Ultra Materials	Proshares
UGE	Ultra Consumer Staples	Proshares
UCC	Ultra Consumer Discretionary	Proshares
RXL	Ultra Health Care	Proshares
UXI	Ultra Industrials	Proshares
DIG	Ultra Energy	Proshares
ROM	Ultra Technology	Proshares
UPW	Ultra Utilities	Proshares
USD	Ultra Semiconductors	Proshares
SZK	UltraShort Consumer Staples	Proshares
RXD	UltraShort Health Care	Proshares
SFK	UltraShort Russell1000 Growth	Proshares
SJH	UltraShort Russell2000 Value	Proshares
SKK	UltraShort Russell2000 Growth	Proshares
SDK	UltraShort Russell MidCap Growth	Proshares
SJL	UltraShort Russell MidCap Value	Proshares
UKF	Ultra Russell1000 Growth	Proshares
UVG	Ultra Russell1000 Value	Proshares
UKW	Ultra Russell MidCap Growth	Proshares
UVU	Ultra Russell MidCap Value	Proshares
UKK	Ultra Russell2000 Growth	Proshares
UVT	Ultra Russell2000 Value	Proshares
ULE	Ultra Euro	Proshares
SJF	UltraShort Russell1000 Value	Proshares
EFZ	Short MSCI EAFE	Proshares
EFU	UltraShort MSCI EAFE	Proshares
EEV	UltraShort MSCI Emerging Markets	Proshares
EUM	Short MSCI Emerging Markets	Proshares
FXP	UltraShort FTSE China 50	Proshares
EWV	UltraShort MSCI Japan	Proshares
TLL	UltraShort Telecommunications	Proshares
LTL	Ultra Communication Services	Proshares
PST	UltraShort 7-10 Year Treasury	Proshares
TBT	UltraShort 20+ Year Treasury	Proshares
SEF	Short Financials	Proshares
DDG	Short Oil & Gas	Proshares
XPP	Ultra FTSE China 50	Proshares
EZJ	Ultra MSCI Japan	Proshares
EFO	Ultra MSCI EAFE	Proshares
EET	Ultra MSCI Emerging Markets	Proshares
BZQ	UltraShort MSCI Brazil Capped	Proshares
EPV	UltraShort FTSE Europe	Proshares
JPX	UltraShort MSCI Pacific ex-Japan	Proshares
SMK	UltraShort MSCI Mexico Capped IMI	Proshares
SPXU	UltraPro Short S&P500	Proshares
UPRO	UltraPro S&P500	Proshares
TWQ	UltraShort Russell3000	Proshares
UWC	Ultra Russell3000	Proshares
CSM	Large Cap Core Plus	Proshares
TBF	Short 20+ Year Treasury	Proshares
UST	Ultra 7-10 Year Treasury	Proshares
UBT	Ultra 20+ Year Treasury	Proshares
SQQQ	UltraPro Short QQQ	Proshares
SMDD	UltraPro Short MidCap400	Proshares
SRTY	UltraPro Short Russell2000	Proshares
TQQQ	UltraPro QQQ	Proshares
UDOW	UltraPro Dow30	Proshares
UMDD	UltraPro MidCap400	Proshares
URTY	UltraPro Russell2000	Proshares
SDOW	UltraPro Short Dow30	Proshares
YXI	Short FTSE China 50	Proshares
REK	Short Real Estate	Proshares
SBM	Short Basic Materials	Proshares
BIB	Ultra Nasdaq Biotechnology	Proshares
BIS	UltraShort Nasdaq Biotechnology	Proshares
KRU	Ultra S&P Regional Banking	Proshares
KRS	Short S&P Regional Banking	Proshares
UXJ	Ultra MSCI Pacific ex-Japan	Proshares
UPV	Ultra FTSE Europe	Proshares
UMX	Ultra MSCI Mexico Capped IMI	Proshares
UBR	Ultra MSCI Brazil Capped	Proshares
HYHG	High Yield&#8212;Interest Rate Hedged	Proshares
NOBL	S&P 500 Dividend Aristocrats ETF	Proshares
TOLZ	DJ Brookfield Global Infrastructure ETF	Proshares
TYTE	CDS North American HY Credit ETF	Proshares
WYDE	CDS Short North American HY Credit ETF	Proshares
EFAD	MSCI EAFE Dividend Growers ETF	Proshares
EMDV	MSCI Emerging Markets Dividend Growers ETF	Proshares
OILU	UltraPro 3x Crude Oil ETF	Proshares
OILD	UltraPro 3x Short Crude Oil ETF	Proshares
SPXB	S&P 500 Bond ETF	Proshares
ONLN	Online Retail ETF	Proshares
PAWZ	Pet Care ETF	Proshares
RALS	RAFI Long/Short	Proshares
TPS	UltraShort TIPS	Proshares
SJB	Short High Yield	Proshares
IGS	Short Investment Grade Corporate	Proshares
TBX	Short 7-10 Year Treasury	Proshares
TBZ	UltraShort 3-7 Year Treasury	Proshares
IGU	Ultra Investment Grade Corporate	Proshares
UJB	Ultra High Yield	Proshares
HDG	Hedge Replication ETF	Proshares
RINF	Inflation Expectations ETF	Proshares
FINF	Short 30 Year TIPS/TSY Spread	Proshares
GGOV	German Sovereign/Sub-Sovereign ETF	Proshares
UINF	UltraPro 10 Year TIPS/TSY Spread	Proshares
SINF	UltraPro Short 10 Year TIPS/TSY Spread	Proshares
TTT	UltraPro Short 20+ Year Treasury	Proshares
COBO	USD Covered Bond	Proshares
FINU	UltraPro Financial Select Sector	Proshares
FINZ	UltraPro Short Financial Select Sector	Proshares
MRGR	Merger ETF	Proshares
PEX	Global Listed Private Equity ETF	Proshares
YCL	Ultra Yen	Proshares
IGHG	Investment Grade&#8212;Interest Rate Hedged	Proshares
UCD	Ultra Bloomberg Commodity	Proshares
UCO	Ultra Bloomberg Crude Oil	Proshares
UGL	Ultra Gold	Proshares
AGQ	Ultra Silver	Proshares
EMSH	Short Term USD Emerging Markets Bond ETF	Proshares
SMDV	Russell 2000 Dividend Growers ETF	Proshares
REGL	S&P MidCap 400 Dividend Aristocrats ETF	Proshares
GDJS	UltraShort Junior Miners	Proshares
GDJJ	Ultra Junior Miners	Proshares
GDXS	UltraShort Gold Miners	Proshares
GDXX	Ultra Gold Miners	Proshares
OILK	K-1 Free Crude Oil ETF	Proshares
EQRR	Equities for Rising Rates ETF	Proshares
CLIX	Long Online/Short Stores ETF	Proshares
EMTY	Decline of the Retail Store ETF	Proshares
VIXY	VIX Short-Term Futures ETF	Proshares
VIXM	VIX Mid-Term Futures ETF	Proshares
FUTS	Managed Futures Strategy (Fund Closing)	Proshares
ALTS	Morningstar Alternatives Solution ETF	Proshares
UOP	Ultra Oil & Gas Exploration & Production	Proshares
SOP	UltraShort Oil & Gas Exploration & Production	Proshares
HBU	Ultra Homebuilders & Supplies	Proshares
HBZ	UltraShort Homebuilders & Supplies	Proshares
UBIO	UltraPro Nasdaq Biotechnology	Proshares
ZBIO	UltraPro Short Nasdaq Biotechnology	Proshares
HGEU	Hedged FTSE Europe ETF	Proshares
HGJP	Hedged FTSE Japan ETF	Proshares
BOIL	Ultra Bloomberg Natural Gas	Proshares
KOLD	UltraShort Bloomberg Natural Gas	Proshares
UVXY	Ultra VIX Short-Term Futures ETF	Proshares
SVXY	Short VIX Short-Term Futures ETF	Proshares
EUDV	MSCI Europe Dividend Growers ETF	Proshares
SPXE	S&P 500 Ex-Energy ETF	Proshares
SPXN	S&P 500 Ex-Financials ETF	Proshares
EUFX	Short Euro	Proshares
SPXV	S&P 500 Ex-Health Care ETF	Proshares
SPXT	S&P 500 Ex-Technology ETF	Proshares
GDAY	Ultra Australian Dollar	Proshares
CROC	UltraShort Australian Dollar	Proshares
FUT	Managed Futures Strategy ETF	Proshares
SCOM	UltraPro Short Communication Services Select Sector	Proshares
UCOM	UltraPro Communication Services Select Sector	Proshares
XCOM	Ultra Communication Services Select Sector	Proshares
YCOM	UltraShort Communication Services Select Sector	Proshares
TMDV	Russell U.S. Dividend Growers ETF	Proshares
TDV	S&P Technology Dividend Aristocrats ETF	Proshares
SKYU	Ultra Nasdaq Cloud Computing	Proshares
UCYB	Ultra Nasdaq Cybersecurity	Proshares
DAT	Big Data Refiners ETF	Proshares
CTEX	S&P Kensho Cleantech ETF	Proshares
MAKX	S&P Kensho Smart Factories ETF	Proshares
BITO	Bitcoin ETF	Proshares
SUPL	Supply Chain Logistics ETF	Proshares
BITI	Short Bitcoin ETF	Proshares
ISPY	S&P 500 High Income ETF	Proshares
QQQA	Nasdaq-100 Dorsey Wright Momentum ETF	Proshares
IQQQ	Nasdaq-100 High Income ETF	Proshares
VERS	Metaverse ETF	Proshares
BETE	Bitcoin & Ether Equal Weight ETF	Proshares
BETH	Bitcoin & Ether Market Cap Weight ETF	Proshares
EETH	Ether ETF	Proshares
BITU	Ultra Bitcoin ETF	Proshares
SBIT	UltraShort Bitcoin ETF	Proshares
ETHT	Ultra Ether ETF	Proshares
ETHD	UltraShort Ether ETF	Proshares
ANEW	MSCI Transformational Changes ETF	Proshares
OND	On-Demand ETF	Proshares
TINT	Smart Materials ETF	Proshares
TINY	Nanotechnology ETF	Proshares
ION	S&P Global Core Battery Metals ETF	Proshares
SETH	Short Ether ETF	Proshares
ITWO	Russell 2000 High Income ETF	Proshares
GLL	UltraShort Gold	Proshares
MYY	Short MidCap400	Proshares
DOG	Short Dow30	Proshares
PSQ	Short QQQ	Proshares
SH	Short S&P500	Proshares
MVV	Ultra MidCap400	Proshares
DDM	Ultra Dow30	Proshares
QLD	Ultra QQQ	Proshares
SSO	Ultra S&P500	Proshares
DXD	UltraShort Dow30	Proshares
QID	UltraShort QQQ	Proshares
MZZ	UltraShort MidCap400	Proshares
SDS	UltraShort S&P500	Proshares
CMD	UltraShort Bloomberg Commodity	Proshares
SCO	UltraShort Bloomberg Crude Oil	Proshares
ZSL	UltraShort Silver	Proshares
EUO	UltraShort Euro	Proshares
YCS	UltraShort Yen	Proshares
SDD	UltraShort SmallCap600	Proshares
TWM	UltraShort Russell2000	Proshares
UWM	Ultra Russell2000	Proshares
RWM	Short Russell2000	Proshares
SAA	Ultra SmallCap600	Proshares
SBB	Short SmallCap600	Proshares
SRS	UltraShort Real Estate	Proshares
SDP	UltraShort Utilities	Proshares
SCC	UltraShort Consumer Discretionary	Proshares
SIJ	UltraShort Industrials	Proshares
UYG	Ultra Financials	Proshares
URE	Ultra Real Estate	Proshares
DUG	UltraShort Energy	Proshares
SSG	UltraShort Semiconductors	Proshares
REW	UltraShort Technology	Proshares
SKF	UltraShort Financials	Proshares
SMN	UltraShort Materials	Proshares
UYM	Ultra Materials	Proshares
UGE	Ultra Consumer Staples	Proshares
UCC	Ultra Consumer Discretionary	Proshares
RXL	Ultra Health Care	Proshares
UXI	Ultra Industrials	Proshares
DIG	Ultra Energy	Proshares
ROM	Ultra Technology	Proshares
UPW	Ultra Utilities	Proshares
USD	Ultra Semiconductors	Proshares
SZK	UltraShort Consumer Staples	Proshares
RXD	UltraShort Health Care	Proshares
SFK	UltraShort Russell1000 Growth	Proshares
SJH	UltraShort Russell2000 Value	Proshares
SKK	UltraShort Russell2000 Growth	Proshares
SDK	UltraShort Russell MidCap Growth	Proshares
SJL	UltraShort Russell MidCap Value	Proshares
UKF	Ultra Russell1000 Growth	Proshares
UVG	Ultra Russell1000 Value	Proshares
UKW	Ultra Russell MidCap Growth	Proshares
UVU	Ultra Russell MidCap Value	Proshares
UKK	Ultra Russell2000 Growth	Proshares
UVT	Ultra Russell2000 Value	Proshares
ULE	Ultra Euro	Proshares
SJF	UltraShort Russell1000 Value	Proshares
EFZ	Short MSCI EAFE	Proshares
EFU	UltraShort MSCI EAFE	Proshares
EEV	UltraShort MSCI Emerging Markets	Proshares
EUM	Short MSCI Emerging Markets	Proshares
FXP	UltraShort FTSE China 50	Proshares
EWV	UltraShort MSCI Japan	Proshares
TLL	UltraShort Telecommunications	Proshares
LTL	Ultra Communication Services	Proshares
PST	UltraShort 7-10 Year Treasury	Proshares
TBT	UltraShort 20+ Year Treasury	Proshares
SEF	Short Financials	Proshares
DDG	Short Oil & Gas	Proshares
XPP	Ultra FTSE China 50	Proshares
EZJ	Ultra MSCI Japan	Proshares
EFO	Ultra MSCI EAFE	Proshares
EET	Ultra MSCI Emerging Markets	Proshares
BZQ	UltraShort MSCI Brazil Capped	Proshares
EPV	UltraShort FTSE Europe	Proshares
JPX	UltraShort MSCI Pacific ex-Japan	Proshares
SMK	UltraShort MSCI Mexico Capped IMI	Proshares
SPXU	UltraPro Short S&P500	Proshares
UPRO	UltraPro S&P500	Proshares
TWQ	UltraShort Russell3000	Proshares
UWC	Ultra Russell3000	Proshares
CSM	Large Cap Core Plus	Proshares
TBF	Short 20+ Year Treasury	Proshares
UST	Ultra 7-10 Year Treasury	Proshares
UBT	Ultra 20+ Year Treasury	Proshares
SQQQ	UltraPro Short QQQ	Proshares
SMDD	UltraPro Short MidCap400	Proshares
SRTY	UltraPro Short Russell2000	Proshares
TQQQ	UltraPro QQQ	Proshares
UDOW	UltraPro Dow30	Proshares
UMDD	UltraPro MidCap400	Proshares
URTY	UltraPro Russell2000	Proshares
SDOW	UltraPro Short Dow30	Proshares
YXI	Short FTSE China 50	Proshares
REK	Short Real Estate	Proshares
SBM	Short Basic Materials	Proshares
BIB	Ultra Nasdaq Biotechnology	Proshares
BIS	UltraShort Nasdaq Biotechnology	Proshares
KRU	Ultra S&P Regional Banking	Proshares
KRS	Short S&P Regional Banking	Proshares
UXJ	Ultra MSCI Pacific ex-Japan	Proshares
UPV	Ultra FTSE Europe	Proshares
UMX	Ultra MSCI Mexico Capped IMI	Proshares
UBR	Ultra MSCI Brazil Capped	Proshares
HYHG	High Yield&#8212;Interest Rate Hedged	Proshares
NOBL	S&P 500 Dividend Aristocrats ETF	Proshares
TOLZ	DJ Brookfield Global Infrastructure ETF	Proshares
TYTE	CDS North American HY Credit ETF	Proshares
WYDE	CDS Short North American HY Credit ETF	Proshares
EFAD	MSCI EAFE Dividend Growers ETF	Proshares
EMDV	MSCI Emerging Markets Dividend Growers ETF	Proshares
OILU	UltraPro 3x Crude Oil ETF	Proshares
OILD	UltraPro 3x Short Crude Oil ETF	Proshares
SPXB	S&P 500 Bond ETF	Proshares
ONLN	Online Retail ETF	Proshares
PAWZ	Pet Care ETF	Proshares
RALS	RAFI Long/Short	Proshares
TPS	UltraShort TIPS	Proshares
SJB	Short High Yield	Proshares
IGS	Short Investment Grade Corporate	Proshares
TBX	Short 7-10 Year Treasury	Proshares
TBZ	UltraShort 3-7 Year Treasury	Proshares
IGU	Ultra Investment Grade Corporate	Proshares
UJB	Ultra High Yield	Proshares
HDG	Hedge Replication ETF	Proshares
RINF	Inflation Expectations ETF	Proshares
FINF	Short 30 Year TIPS/TSY Spread	Proshares
GGOV	German Sovereign/Sub-Sovereign ETF	Proshares
UINF	UltraPro 10 Year TIPS/TSY Spread	Proshares
SINF	UltraPro Short 10 Year TIPS/TSY Spread	Proshares
TTT	UltraPro Short 20+ Year Treasury	Proshares
COBO	USD Covered Bond	Proshares
FINU	UltraPro Financial Select Sector	Proshares
FINZ	UltraPro Short Financial Select Sector	Proshares
MRGR	Merger ETF	Proshares
PEX	Global Listed Private Equity ETF	Proshares
YCL	Ultra Yen	Proshares
IGHG	Investment Grade&#8212;Interest Rate Hedged	Proshares
UCD	Ultra Bloomberg Commodity	Proshares
UCO	Ultra Bloomberg Crude Oil	Proshares
UGL	Ultra Gold	Proshares
AGQ	Ultra Silver	Proshares
EMSH	Short Term USD Emerging Markets Bond ETF	Proshares
SMDV	Russell 2000 Dividend Growers ETF	Proshares
REGL	S&P MidCap 400 Dividend Aristocrats ETF	Proshares
GDJS	UltraShort Junior Miners	Proshares
GDJJ	Ultra Junior Miners	Proshares
GDXS	UltraShort Gold Miners	Proshares
GDXX	Ultra Gold Miners	Proshares
OILK	K-1 Free Crude Oil ETF	Proshares
EQRR	Equities for Rising Rates ETF	Proshares
CLIX	Long Online/Short Stores ETF	Proshares
EMTY	Decline of the Retail Store ETF	Proshares
VIXY	VIX Short-Term Futures ETF	Proshares
VIXM	VIX Mid-Term Futures ETF	Proshares
FUTS	Managed Futures Strategy (Fund Closing)	Proshares
ALTS	Morningstar Alternatives Solution ETF	Proshares
UOP	Ultra Oil & Gas Exploration & Production	Proshares
SOP	UltraShort Oil & Gas Exploration & Production	Proshares
HBU	Ultra Homebuilders & Supplies	Proshares
HBZ	UltraShort Homebuilders & Supplies	Proshares
UBIO	UltraPro Nasdaq Biotechnology	Proshares
ZBIO	UltraPro Short Nasdaq Biotechnology	Proshares
HGEU	Hedged FTSE Europe ETF	Proshares
HGJP	Hedged FTSE Japan ETF	Proshares
BOIL	Ultra Bloomberg Natural Gas	Proshares
KOLD	UltraShort Bloomberg Natural Gas	Proshares
UVXY	Ultra VIX Short-Term Futures ETF	Proshares
SVXY	Short VIX Short-Term Futures ETF	Proshares
EUDV	MSCI Europe Dividend Growers ETF	Proshares
SPXE	S&P 500 Ex-Energy ETF	Proshares
SPXN	S&P 500 Ex-Financials ETF	Proshares
EUFX	Short Euro	Proshares
SPXV	S&P 500 Ex-Health Care ETF	Proshares
SPXT	S&P 500 Ex-Technology ETF	Proshares
GDAY	Ultra Australian Dollar	Proshares
CROC	UltraShort Australian Dollar	Proshares
FUT	Managed Futures Strategy ETF	Proshares
SCOM	UltraPro Short Communication Services Select Sector	Proshares
UCOM	UltraPro Communication Services Select Sector	Proshares
XCOM	Ultra Communication Services Select Sector	Proshares
YCOM	UltraShort Communication Services Select Sector	Proshares
TMDV	Russell U.S. Dividend Growers ETF	Proshares
TDV	S&P Technology Dividend Aristocrats ETF	Proshares
SKYU	Ultra Nasdaq Cloud Computing	Proshares
UCYB	Ultra Nasdaq Cybersecurity	Proshares
DAT	Big Data Refiners ETF	Proshares
CTEX	S&P Kensho Cleantech ETF	Proshares
MAKX	S&P Kensho Smart Factories ETF	Proshares
BITO	Bitcoin ETF	Proshares
SUPL	Supply Chain Logistics ETF	Proshares
BITI	Short Bitcoin ETF	Proshares
ISPY	S&P 500 High Income ETF	Proshares
QQQA	Nasdaq-100 Dorsey Wright Momentum ETF	Proshares
IQQQ	Nasdaq-100 High Income ETF	Proshares
VERS	Metaverse ETF	Proshares
BETE	Bitcoin & Ether Equal Weight ETF	Proshares
BETH	Bitcoin & Ether Market Cap Weight ETF	Proshares
EETH	Ether ETF	Proshares
BITU	Ultra Bitcoin ETF	Proshares
SBIT	UltraShort Bitcoin ETF	Proshares
ETHT	Ultra Ether ETF	Proshares
ETHD	UltraShort Ether ETF	Proshares
ANEW	MSCI Transformational Changes ETF	Proshares
OND	On-Demand ETF	Proshares
TINT	Smart Materials ETF	Proshares
TINY	Nanotechnology ETF	Proshares
ION	S&P Global Core Battery Metals ETF	Proshares
SETH	Short Ether ETF	Proshares
ITWO	Russell 2000 High Income ETF	Proshares
GLL	UltraShort Gold	Proshares
MYY	Short MidCap400	Proshares
DOG	Short Dow30	Proshares
PSQ	Short QQQ	Proshares
SH	Short S&P500	Proshares
MVV	Ultra MidCap400	Proshares
DDM	Ultra Dow30	Proshares
QLD	Ultra QQQ	Proshares
SSO	Ultra S&P500	Proshares
DXD	UltraShort Dow30	Proshares
QID	UltraShort QQQ	Proshares
MZZ	UltraShort MidCap400	Proshares
SDS	UltraShort S&P500	Proshares
CMD	UltraShort Bloomberg Commodity	Proshares
SCO	UltraShort Bloomberg Crude Oil	Proshares
ZSL	UltraShort Silver	Proshares
EUO	UltraShort Euro	Proshares
YCS	UltraShort Yen	Proshares
SDD	UltraShort SmallCap600	Proshares
TWM	UltraShort Russell2000	Proshares
UWM	Ultra Russell2000	Proshares
RWM	Short Russell2000	Proshares
SAA	Ultra SmallCap600	Proshares
SBB	Short SmallCap600	Proshares
SRS	UltraShort Real Estate	Proshares
SDP	UltraShort Utilities	Proshares
SCC	UltraShort Consumer Discretionary	Proshares
SIJ	UltraShort Industrials	Proshares
UYG	Ultra Financials	Proshares
URE	Ultra Real Estate	Proshares
DUG	UltraShort Energy	Proshares
SSG	UltraShort Semiconductors	Proshares
REW	UltraShort Technology	Proshares
SKF	UltraShort Financials	Proshares
SMN	UltraShort Materials	Proshares
UYM	Ultra Materials	Proshares
UGE	Ultra Consumer Staples	Proshares
UCC	Ultra Consumer Discretionary	Proshares
RXL	Ultra Health Care	Proshares
UXI	Ultra Industrials	Proshares
DIG	Ultra Energy	Proshares
ROM	Ultra Technology	Proshares
UPW	Ultra Utilities	Proshares
USD	Ultra Semiconductors	Proshares
SZK	UltraShort Consumer Staples	Proshares
RXD	UltraShort Health Care	Proshares
SFK	UltraShort Russell1000 Growth	Proshares
SJH	UltraShort Russell2000 Value	Proshares
SKK	UltraShort Russell2000 Growth	Proshares
SDK	UltraShort Russell MidCap Growth	Proshares
SJL	UltraShort Russell MidCap Value	Proshares
UKF	Ultra Russell1000 Growth	Proshares
UVG	Ultra Russell1000 Value	Proshares
UKW	Ultra Russell MidCap Growth	Proshares
UVU	Ultra Russell MidCap Value	Proshares
UKK	Ultra Russell2000 Growth	Proshares
UVT	Ultra Russell2000 Value	Proshares
ULE	Ultra Euro	Proshares
SJF	UltraShort Russell1000 Value	Proshares
EFZ	Short MSCI EAFE	Proshares
EFU	UltraShort MSCI EAFE	Proshares
EEV	UltraShort MSCI Emerging Markets	Proshares
EUM	Short MSCI Emerging Markets	Proshares
FXP	UltraShort FTSE China 50	Proshares
EWV	UltraShort MSCI Japan	Proshares
TLL	UltraShort Telecommunications	Proshares
LTL	Ultra Communication Services	Proshares
PST	UltraShort 7-10 Year Treasury	Proshares
TBT	UltraShort 20+ Year Treasury	Proshares
SEF	Short Financials	Proshares
DDG	Short Oil & Gas	Proshares
XPP	Ultra FTSE China 50	Proshares
EZJ	Ultra MSCI Japan	Proshares
EFO	Ultra MSCI EAFE	Proshares
EET	Ultra MSCI Emerging Markets	Proshares
BZQ	UltraShort MSCI Brazil Capped	Proshares
EPV	UltraShort FTSE Europe	Proshares
JPX	UltraShort MSCI Pacific ex-Japan	Proshares
SMK	UltraShort MSCI Mexico Capped IMI	Proshares
SPXU	UltraPro Short S&P500	Proshares
UPRO	UltraPro S&P500	Proshares
TWQ	UltraShort Russell3000	Proshares
UWC	Ultra Russell3000	Proshares
CSM	Large Cap Core Plus	Proshares
TBF	Short 20+ Year Treasury	Proshares
UST	Ultra 7-10 Year Treasury	Proshares
UBT	Ultra 20+ Year Treasury	Proshares
SQQQ	UltraPro Short QQQ	Proshares
SMDD	UltraPro Short MidCap400	Proshares
SRTY	UltraPro Short Russell2000	Proshares
TQQQ	UltraPro QQQ	Proshares
UDOW	UltraPro Dow30	Proshares
UMDD	UltraPro MidCap400	Proshares
URTY	UltraPro Russell2000	Proshares
SDOW	UltraPro Short Dow30	Proshares
YXI	Short FTSE China 50	Proshares
REK	Short Real Estate	Proshares
SBM	Short Basic Materials	Proshares
BIB	Ultra Nasdaq Biotechnology	Proshares
BIS	UltraShort Nasdaq Biotechnology	Proshares
KRU	Ultra S&P Regional Banking	Proshares
KRS	Short S&P Regional Banking	Proshares
UXJ	Ultra MSCI Pacific ex-Japan	Proshares
UPV	Ultra FTSE Europe	Proshares
UMX	Ultra MSCI Mexico Capped IMI	Proshares
UBR	Ultra MSCI Brazil Capped	Proshares
HYHG	High Yield&#8212;Interest Rate Hedged	Proshares
NOBL	S&P 500 Dividend Aristocrats ETF	Proshares
TOLZ	DJ Brookfield Global Infrastructure ETF	Proshares
TYTE	CDS North American HY Credit ETF	Proshares
WYDE	CDS Short North American HY Credit ETF	Proshares
EFAD	MSCI EAFE Dividend Growers ETF	Proshares
EMDV	MSCI Emerging Markets Dividend Growers ETF	Proshares
OILU	UltraPro 3x Crude Oil ETF	Proshares
OILD	UltraPro 3x Short Crude Oil ETF	Proshares
SPXB	S&P 500 Bond ETF	Proshares
ONLN	Online Retail ETF	Proshares
PAWZ	Pet Care ETF	Proshares
RALS	RAFI Long/Short	Proshares
TPS	UltraShort TIPS	Proshares
SJB	Short High Yield	Proshares
IGS	Short Investment Grade Corporate	Proshares
TBX	Short 7-10 Year Treasury	Proshares
TBZ	UltraShort 3-7 Year Treasury	Proshares
IGU	Ultra Investment Grade Corporate	Proshares
UJB	Ultra High Yield	Proshares
HDG	Hedge Replication ETF	Proshares
RINF	Inflation Expectations ETF	Proshares
FINF	Short 30 Year TIPS/TSY Spread	Proshares
GGOV	German Sovereign/Sub-Sovereign ETF	Proshares
UINF	UltraPro 10 Year TIPS/TSY Spread	Proshares
SINF	UltraPro Short 10 Year TIPS/TSY Spread	Proshares
TTT	UltraPro Short 20+ Year Treasury	Proshares
COBO	USD Covered Bond	Proshares
FINU	UltraPro Financial Select Sector	Proshares
FINZ	UltraPro Short Financial Select Sector	Proshares
MRGR	Merger ETF	Proshares
PEX	Global Listed Private Equity ETF	Proshares
YCL	Ultra Yen	Proshares
IGHG	Investment Grade&#8212;Interest Rate Hedged	Proshares
UCD	Ultra Bloomberg Commodity	Proshares
UCO	Ultra Bloomberg Crude Oil	Proshares
UGL	Ultra Gold	Proshares
AGQ	Ultra Silver	Proshares
EMSH	Short Term USD Emerging Markets Bond ETF	Proshares
SMDV	Russell 2000 Dividend Growers ETF	Proshares
REGL	S&P MidCap 400 Dividend Aristocrats ETF	Proshares
GDJS	UltraShort Junior Miners	Proshares
GDJJ	Ultra Junior Miners	Proshares
GDXS	UltraShort Gold Miners	Proshares
GDXX	Ultra Gold Miners	Proshares
OILK	K-1 Free Crude Oil ETF	Proshares
EQRR	Equities for Rising Rates ETF	Proshares
CLIX	Long Online/Short Stores ETF	Proshares
EMTY	Decline of the Retail Store ETF	Proshares
VIXY	VIX Short-Term Futures ETF	Proshares
VIXM	VIX Mid-Term Futures ETF	Proshares
FUTS	Managed Futures Strategy (Fund Closing)	Proshares
ALTS	Morningstar Alternatives Solution ETF	Proshares
UOP	Ultra Oil & Gas Exploration & Production	Proshares
SOP	UltraShort Oil & Gas Exploration & Production	Proshares
HBU	Ultra Homebuilders & Supplies	Proshares
HBZ	UltraShort Homebuilders & Supplies	Proshares
UBIO	UltraPro Nasdaq Biotechnology	Proshares
ZBIO	UltraPro Short Nasdaq Biotechnology	Proshares
HGEU	Hedged FTSE Europe ETF	Proshares
HGJP	Hedged FTSE Japan ETF	Proshares
BOIL	Ultra Bloomberg Natural Gas	Proshares
KOLD	UltraShort Bloomberg Natural Gas	Proshares
UVXY	Ultra VIX Short-Term Futures ETF	Proshares
SVXY	Short VIX Short-Term Futures ETF	Proshares
EUDV	MSCI Europe Dividend Growers ETF	Proshares
SPXE	S&P 500 Ex-Energy ETF	Proshares
SPXN	S&P 500 Ex-Financials ETF	Proshares
EUFX	Short Euro	Proshares
SPXV	S&P 500 Ex-Health Care ETF	Proshares
SPXT	S&P 500 Ex-Technology ETF	Proshares
GDAY	Ultra Australian Dollar	Proshares
CROC	UltraShort Australian Dollar	Proshares
FUT	Managed Futures Strategy ETF	Proshares
SCOM	UltraPro Short Communication Services Select Sector	Proshares
UCOM	UltraPro Communication Services Select Sector	Proshares
XCOM	Ultra Communication Services Select Sector	Proshares
YCOM	UltraShort Communication Services Select Sector	Proshares
TMDV	Russell U.S. Dividend Growers ETF	Proshares
TDV	S&P Technology Dividend Aristocrats ETF	Proshares
SKYU	Ultra Nasdaq Cloud Computing	Proshares
UCYB	Ultra Nasdaq Cybersecurity	Proshares
DAT	Big Data Refiners ETF	Proshares
CTEX	S&P Kensho Cleantech ETF	Proshares
MAKX	S&P Kensho Smart Factories ETF	Proshares
BITO	Bitcoin ETF	Proshares
SUPL	Supply Chain Logistics ETF	Proshares
BITI	Short Bitcoin ETF	Proshares
ISPY	S&P 500 High Income ETF	Proshares
QQQA	Nasdaq-100 Dorsey Wright Momentum ETF	Proshares
IQQQ	Nasdaq-100 High Income ETF	Proshares
VERS	Metaverse ETF	Proshares
BETE	Bitcoin & Ether Equal Weight ETF	Proshares
BETH	Bitcoin & Ether Market Cap Weight ETF	Proshares
EETH	Ether ETF	Proshares
BITU	Ultra Bitcoin ETF	Proshares
SBIT	UltraShort Bitcoin ETF	Proshares
ETHT	Ultra Ether ETF	Proshares
ETHD	UltraShort Ether ETF	Proshares
ANEW	MSCI Transformational Changes ETF	Proshares
OND	On-Demand ETF	Proshares
TINT	Smart Materials ETF	Proshares
TINY	Nanotechnology ETF	Proshares
ION	S&P Global Core Battery Metals ETF	Proshares
SETH	Short Ether ETF	Proshares
ITWO	Russell 2000 High Income ETF	Proshares
GLL	UltraShort Gold	Proshares
MYY	Short MidCap400	Proshares
DOG	Short Dow30	Proshares
PSQ	Short QQQ	Proshares
SH	Short S&P500	Proshares
MVV	Ultra MidCap400	Proshares
DDM	Ultra Dow30	Proshares
QLD	Ultra QQQ	Proshares
SSO	Ultra S&P500	Proshares
DXD	UltraShort Dow30	Proshares
QID	UltraShort QQQ	Proshares
MZZ	UltraShort MidCap400	Proshares
SDS	UltraShort S&P500	Proshares
CMD	UltraShort Bloomberg Commodity	Proshares
SCO	UltraShort Bloomberg Crude Oil	Proshares
ZSL	UltraShort Silver	Proshares
EUO	UltraShort Euro	Proshares
YCS	UltraShort Yen	Proshares
SDD	UltraShort SmallCap600	Proshares
TWM	UltraShort Russell2000	Proshares
UWM	Ultra Russell2000	Proshares
RWM	Short Russell2000	Proshares
SAA	Ultra SmallCap600	Proshares
SBB	Short SmallCap600	Proshares
SRS	UltraShort Real Estate	Proshares
SDP	UltraShort Utilities	Proshares
SCC	UltraShort Consumer Discretionary	Proshares
SIJ	UltraShort Industrials	Proshares
UYG	Ultra Financials	Proshares
URE	Ultra Real Estate	Proshares
DUG	UltraShort Energy	Proshares
SSG	UltraShort Semiconductors	Proshares
REW	UltraShort Technology	Proshares
SKF	UltraShort Financials	Proshares
SMN	UltraShort Materials	Proshares
UYM	Ultra Materials	Proshares
UGE	Ultra Consumer Staples	Proshares
UCC	Ultra Consumer Discretionary	Proshares
RXL	Ultra Health Care	Proshares
UXI	Ultra Industrials	Proshares
DIG	Ultra Energy	Proshares
ROM	Ultra Technology	Proshares
UPW	Ultra Utilities	Proshares
USD	Ultra Semiconductors	Proshares
SZK	UltraShort Consumer Staples	Proshares
RXD	UltraShort Health Care	Proshares
SFK	UltraShort Russell1000 Growth	Proshares
SJH	UltraShort Russell2000 Value	Proshares
SKK	UltraShort Russell2000 Growth	Proshares
SDK	UltraShort Russell MidCap Growth	Proshares
SJL	UltraShort Russell MidCap Value	Proshares
UKF	Ultra Russell1000 Growth	Proshares
UVG	Ultra Russell1000 Value	Proshares
UKW	Ultra Russell MidCap Growth	Proshares
UVU	Ultra Russell MidCap Value	Proshares
UKK	Ultra Russell2000 Growth	Proshares
UVT	Ultra Russell2000 Value	Proshares
ULE	Ultra Euro	Proshares
SJF	UltraShort Russell1000 Value	Proshares
EFZ	Short MSCI EAFE	Proshares
EFU	UltraShort MSCI EAFE	Proshares
EEV	UltraShort MSCI Emerging Markets	Proshares
EUM	Short MSCI Emerging Markets	Proshares
FXP	UltraShort FTSE China 50	Proshares
EWV	UltraShort MSCI Japan	Proshares
TLL	UltraShort Telecommunications	Proshares
LTL	Ultra Communication Services	Proshares
PST	UltraShort 7-10 Year Treasury	Proshares
TBT	UltraShort 20+ Year Treasury	Proshares
SEF	Short Financials	Proshares
DDG	Short Oil & Gas	Proshares
XPP	Ultra FTSE China 50	Proshares
EZJ	Ultra MSCI Japan	Proshares
EFO	Ultra MSCI EAFE	Proshares
EET	Ultra MSCI Emerging Markets	Proshares
BZQ	UltraShort MSCI Brazil Capped	Proshares
EPV	UltraShort FTSE Europe	Proshares
JPX	UltraShort MSCI Pacific ex-Japan	Proshares
SMK	UltraShort MSCI Mexico Capped IMI	Proshares
SPXU	UltraPro Short S&P500	Proshares
UPRO	UltraPro S&P500	Proshares
TWQ	UltraShort Russell3000	Proshares
UWC	Ultra Russell3000	Proshares
CSM	Large Cap Core Plus	Proshares
TBF	Short 20+ Year Treasury	Proshares
UST	Ultra 7-10 Year Treasury	Proshares
UBT	Ultra 20+ Year Treasury	Proshares
SQQQ	UltraPro Short QQQ	Proshares
SMDD	UltraPro Short MidCap400	Proshares
SRTY	UltraPro Short Russell2000	Proshares
TQQQ	UltraPro QQQ	Proshares
UDOW	UltraPro Dow30	Proshares
UMDD	UltraPro MidCap400	Proshares
URTY	UltraPro Russell2000	Proshares
SDOW	UltraPro Short Dow30	Proshares
YXI	Short FTSE China 50	Proshares
REK	Short Real Estate	Proshares
SBM	Short Basic Materials	Proshares
BIB	Ultra Nasdaq Biotechnology	Proshares
BIS	UltraShort Nasdaq Biotechnology	Proshares
KRU	Ultra S&P Regional Banking	Proshares
KRS	Short S&P Regional Banking	Proshares
UXJ	Ultra MSCI Pacific ex-Japan	Proshares
UPV	Ultra FTSE Europe	Proshares
UMX	Ultra MSCI Mexico Capped IMI	Proshares
UBR	Ultra MSCI Brazil Capped	Proshares
HYHG	High Yield&#8212;Interest Rate Hedged	Proshares
NOBL	S&P 500 Dividend Aristocrats ETF	Proshares
TOLZ	DJ Brookfield Global Infrastructure ETF	Proshares
TYTE	CDS North American HY Credit ETF	Proshares
WYDE	CDS Short North American HY Credit ETF	Proshares
EFAD	MSCI EAFE Dividend Growers ETF	Proshares
EMDV	MSCI Emerging Markets Dividend Growers ETF	Proshares
OILU	UltraPro 3x Crude Oil ETF	Proshares
OILD	UltraPro 3x Short Crude Oil ETF	Proshares
SPXB	S&P 500 Bond ETF	Proshares
ONLN	Online Retail ETF	Proshares
PAWZ	Pet Care ETF	Proshares
RALS	RAFI Long/Short	Proshares
TPS	UltraShort TIPS	Proshares
SJB	Short High Yield	Proshares
IGS	Short Investment Grade Corporate	Proshares
TBX	Short 7-10 Year Treasury	Proshares
TBZ	UltraShort 3-7 Year Treasury	Proshares
IGU	Ultra Investment Grade Corporate	Proshares
UJB	Ultra High Yield	Proshares
HDG	Hedge Replication ETF	Proshares
RINF	Inflation Expectations ETF	Proshares
FINF	Short 30 Year TIPS/TSY Spread	Proshares
GGOV	German Sovereign/Sub-Sovereign ETF	Proshares
UINF	UltraPro 10 Year TIPS/TSY Spread	Proshares
SINF	UltraPro Short 10 Year TIPS/TSY Spread	Proshares
TTT	UltraPro Short 20+ Year Treasury	Proshares
COBO	USD Covered Bond	Proshares
FINU	UltraPro Financial Select Sector	Proshares
FINZ	UltraPro Short Financial Select Sector	Proshares
MRGR	Merger ETF	Proshares
PEX	Global Listed Private Equity ETF	Proshares
YCL	Ultra Yen	Proshares
IGHG	Investment Grade&#8212;Interest Rate Hedged	Proshares
UCD	Ultra Bloomberg Commodity	Proshares
UCO	Ultra Bloomberg Crude Oil	Proshares
UGL	Ultra Gold	Proshares
AGQ	Ultra Silver	Proshares
EMSH	Short Term USD Emerging Markets Bond ETF	Proshares
SMDV	Russell 2000 Dividend Growers ETF	Proshares
REGL	S&P MidCap 400 Dividend Aristocrats ETF	Proshares
GDJS	UltraShort Junior Miners	Proshares
GDJJ	Ultra Junior Miners	Proshares
GDXS	UltraShort Gold Miners	Proshares
GDXX	Ultra Gold Miners	Proshares
OILK	K-1 Free Crude Oil ETF	Proshares
EQRR	Equities for Rising Rates ETF	Proshares
CLIX	Long Online/Short Stores ETF	Proshares
EMTY	Decline of the Retail Store ETF	Proshares
VIXY	VIX Short-Term Futures ETF	Proshares
VIXM	VIX Mid-Term Futures ETF	Proshares
FUTS	Managed Futures Strategy (Fund Closing)	Proshares
ALTS	Morningstar Alternatives Solution ETF	Proshares
UOP	Ultra Oil & Gas Exploration & Production	Proshares
SOP	UltraShort Oil & Gas Exploration & Production	Proshares
HBU	Ultra Homebuilders & Supplies	Proshares
HBZ	UltraShort Homebuilders & Supplies	Proshares
UBIO	UltraPro Nasdaq Biotechnology	Proshares
ZBIO	UltraPro Short Nasdaq Biotechnology	Proshares
HGEU	Hedged FTSE Europe ETF	Proshares
HGJP	Hedged FTSE Japan ETF	Proshares
BOIL	Ultra Bloomberg Natural Gas	Proshares
KOLD	UltraShort Bloomberg Natural Gas	Proshares
UVXY	Ultra VIX Short-Term Futures ETF	Proshares
SVXY	Short VIX Short-Term Futures ETF	Proshares
EUDV	MSCI Europe Dividend Growers ETF	Proshares
SPXE	S&P 500 Ex-Energy ETF	Proshares
SPXN	S&P 500 Ex-Financials ETF	Proshares
EUFX	Short Euro	Proshares
SPXV	S&P 500 Ex-Health Care ETF	Proshares
SPXT	S&P 500 Ex-Technology ETF	Proshares
GDAY	Ultra Australian Dollar	Proshares
CROC	UltraShort Australian Dollar	Proshares
FUT	Managed Futures Strategy ETF	Proshares
SCOM	UltraPro Short Communication Services Select Sector	Proshares
UCOM	UltraPro Communication Services Select Sector	Proshares
XCOM	Ultra Communication Services Select Sector	Proshares
YCOM	UltraShort Communication Services Select Sector	Proshares
TMDV	Russell U.S. Dividend Growers ETF	Proshares
TDV	S&P Technology Dividend Aristocrats ETF	Proshares
SKYU	Ultra Nasdaq Cloud Computing	Proshares
UCYB	Ultra Nasdaq Cybersecurity	Proshares
DAT	Big Data Refiners ETF	Proshares
CTEX	S&P Kensho Cleantech ETF	Proshares
MAKX	S&P Kensho Smart Factories ETF	Proshares
BITO	Bitcoin ETF	Proshares
SUPL	Supply Chain Logistics ETF	Proshares
BITI	Short Bitcoin ETF	Proshares
ISPY	S&P 500 High Income ETF	Proshares
QQQA	Nasdaq-100 Dorsey Wright Momentum ETF	Proshares
IQQQ	Nasdaq-100 High Income ETF	Proshares
VERS	Metaverse ETF	Proshares
BETE	Bitcoin & Ether Equal Weight ETF	Proshares
BETH	Bitcoin & Ether Market Cap Weight ETF	Proshares
EETH	Ether ETF	Proshares
BITU	Ultra Bitcoin ETF	Proshares
SBIT	UltraShort Bitcoin ETF	Proshares
ETHT	Ultra Ether ETF	Proshares
ETHD	UltraShort Ether ETF	Proshares
ANEW	MSCI Transformational Changes ETF	Proshares
OND	On-Demand ETF	Proshares
TINT	Smart Materials ETF	Proshares
TINY	Nanotechnology ETF	Proshares
ION	S&P Global Core Battery Metals ETF	Proshares
SETH	Short Ether ETF	Proshares
ITWO	Russell 2000 High Income ETF	Proshares
CLOB	VanEck AA-BB CLO ETF	VanEck
AFK	VanEck Africa Index ETF	VanEck
MOO	VanEck Agribusiness ETF	VanEck
BIZD	VanEck BDC Income ETF	VanEck
BBH	VanEck Biotech ETF	VanEck
HODL	VanEck Bitcoin ETF	VanEck
BRF	VanEck Brazil Small-Cap ETF	VanEck
XMPT	VanEck CEF Muni Income ETF	VanEck
CBON	VanEck China Bond ETF	VanEck
CNXT	VanEck ChiNext ETF	VanEck
CLOI	VanEck CLO ETF	VanEck
CMCI	VanEck CMCI Commodity Strategy ETF	VanEck
PIT	VanEck Commodity Strategy ETF	VanEck
DGIN	VanEck Digital India ETF	VanEck
DAPP	VanEck Digital Transformation ETF	VanEck
DURA	VanEck Durable High Dividend ETF	VanEck
HYEM	VanEck Emerging Markets High Yield Bond ETF	VanEck
EINC	VanEck Energy Income ETF	VanEck
EVX	VanEck Environmental Services ETF	VanEck
ETHV	VanEck Ethereum ETF	VanEck
SMHX	VanEck Fabless Semiconductor ETF	VanEck
ANGL	VanEck Fallen Angel High Yield Bond ETF	VanEck
BJK	VanEck Gaming ETF	VanEck
GDX	VanEck Gold Miners ETF	VanEck
GRNB	VanEck Green Bond ETF	VanEck
RNEW	VanEck Green Infrastructure ETF	VanEck
GMET	VanEck Green Metals ETF	VanEck
HYD	VanEck High Yield Muni ETF	VanEck
SMI	VanEck HIP Sustainable Muni ETF	VanEck
FLTR	VanEck IG Floating Rate ETF	VanEck
GLIN	VanEck India Growth Leaders ETF	VanEck
IDX	VanEck Indonesia Index ETF	VanEck
ITM	VanEck Intermediate Muni ETF	VanEck
IHY	VanEck International High Yield Bond ETF	VanEck
ISRA	VanEck Israel ETF	VanEck
EMLC	VanEck J.P. Morgan EM Local Currency Bond ETF	VanEck
GDXJ	VanEck Junior Gold Miners ETF	VanEck
MLN	VanEck Long Muni ETF	VanEck
SMOG	VanEck Low Carbon Energy ETF	VanEck
OUNZ	VanEck Merk Gold ETF	VanEck
MBBB	VanEck Moody’s Analytics BBB Corporate Bond ETF	VanEck
MIG	VanEck Moody’s Analytics IG Corporate Bond ETF	VanEck
MORT	VanEck Mortgage REIT Income ETF	VanEck
HAP	VanEck Natural Resources ETF	VanEck
DESK	VanEck Office and Commercial REIT ETF	VanEck
CRAK	VanEck Oil Refiners ETF	VanEck
OIH	VanEck Oil Services ETF	VanEck
PPH	VanEck Pharmaceutical ETF	VanEck
PFXF	VanEck Preferred Securities ex Financials ETF	VanEck
REMX	VanEck Rare Earth and Strategic Metals ETF	VanEck
RAAX	VanEck Real Assets ETF	VanEck
RTH	VanEck Retail ETF	VanEck
IBOT	VanEck Robotics ETF	VanEck
RSX	VanEck Russia ETF	VanEck
RSXJ	VanEck Russia Small-Cap ETF	VanEck
SMH	VanEck Semiconductor ETF	VanEck
SHYD	VanEck Short High Yield Muni ETF	VanEck
SMB	VanEck Short Muni ETF	VanEck
SLX	VanEck Steel ETF	VanEck
NLR	VanEck Uranium and Nuclear ETF	VanEck
ESPO	VanEck Video Gaming and eSports ETF	VanEck
VNM	VanEck Vietnam ETF	VanEck